資料日期,股票代號,股票名稱,本週餘額,上週餘額,增減數額,增減比率,發行比率
1090529,006201,元大富櫃50,21446,21446,0,0.00,100.00
1090529,00679B,元大美債20年,394192,397692,-3500,-0.88,99.74
1090529,00687B,國泰20年美債,261787,231287,30500,13.18,98.86
1090529,00694B,富邦美債1-3,190076,190076,0,0.00,100.00
1090529,00695B,富邦美債7-10,9186,9186,0,0.00,100.00
1090529,00696B,富邦美債20年,442181,340181,102000,29.98,95.67
1090529,00697B,元大美債7-10,5712,5712,0,0.00,100.00
1090529,00718B,富邦中國政策債,1144501,1144001,500,0.04,100.00
1090529,00719B,元大美債1-3,601514,603014,-1500,-0.24,100.00
1090529,00720B,元大投資級公司債,503609,511609,-8000,-1.56,91.54
1090529,00721B,元大中國債3-5,459122,459122,0,0.00,100.00
1090529,00722B,群益IG電信債,622239,603739,18500,3.06,100.00
1090529,00723B,群益IG科技債,765583,746083,19500,2.61,100.00
1090529,00724B,群益IG金融債,1228775,1212775,16000,1.31,100.00
1090529,00725B,國泰投資級公司債,610706,610706,0,0.00,100.00
1090529,00726B,國泰5Y+新興債,1044489,1023989,20500,2.00,99.05
1090529,00727B,國泰1-5Y高收債,184189,184189,0,0.00,100.00
1090529,00734B,台新ＪＰＭ新興債,31979,31979,0,0.00,100.00
1090529,00740B,富邦全球投等債,429971,384971,45000,11.68,100.00
1090529,00741B,富邦全球高收債,17628,17628,0,0.00,100.00
1090529,00744B,國泰中國政金債5+,1027728,1027728,0,0.00,100.00
1090529,00745B,富邦中政債0-1,5516,5516,0,0.00,100.00
1090529,00746B,富邦A級公司債,990464,989464,1000,0.10,100.00
1090529,00747B,FH中國政策債,824500,824500,0,0.00,100.00
1090529,00748B,凱基中國債3-10,624000,624500,-500,-0.08,100.00
1090529,00749B,凱基新興債10+,864500,863500,1000,0.11,100.00
1090529,00750B,凱基科技債10+,163000,163000,0,0.00,100.00
1090529,00751B,元大AAA至A公司債,1254603,1291603,-37000,-2.86,100.00
1090529,00754B,群益AAA-AA公司債,349400,349400,0,0.00,100.00
1090529,00755B,群益15年IG公用債,196730,177230,19500,11.00,100.00
1090529,00756B,群益15年EM主權債,965300,936300,29000,3.09,98.97
1090529,00758B,FH能源債,20525,20525,0,0.00,100.00
1090529,00759B,FH製藥債,55025,55025,0,0.00,100.00
1090529,00760B,FH新興企業債,305020,289520,15500,5.35,95.31
1090529,00761B,國泰A級公司債,1206089,1237089,-31000,-2.50,100.00
1090529,00764B,群益25年美債,387500,330000,57500,17.42,100.00
1090529,00765B,群益中國政金債,3000,3000,0,0.00,100.00
1090529,00768B,FH20年美債,8100,8100,0,0.00,100.00
1090529,00772B,中信高評級公司債,1518290,1518290,0,0.00,98.76
1090529,00773B,中信優先金融債,566790,615290,-48500,-7.88,100.00
1090529,00777B,凱基AAA至A公司債,397150,393150,4000,1.01,99.74
1090529,00778B,凱基金融債20+,219650,180150,39500,21.92,91.84
1090529,00779B,凱基美債25+,139650,139650,0,0.00,100.00
1090529,00780B,國泰A級金融債,307602,306102,1500,0.49,100.00
1090529,00781B,國泰A級科技債,19336,19336,0,0.00,100.00
1090529,00782B,國泰A級公用債,27467,41467,-14000,-33.76,100.00
1090529,00784B,富邦中國投等債,3993,3993,0,0.00,100.00
1090529,00785B,富邦金融投等債,291966,291966,0,0.00,100.00
1090529,00786B,元大10年IG銀行債,10066,9566,500,5.22,100.00
1090529,00787B,元大10年IG醫療債,16806,16806,0,0.00,100.00
1090529,00788B,元大10年IG電能債,38706,38706,0,0.00,100.00
1090529,00789B,FH公司債A3,65600,98100,-32500,-33.12,100.00
1090529,00790B,FH次順位IG金融債,2100,2100,0,0.00,100.00
1090529,00791B,FH美元信用債1-5Y,355100,355100,0,0.00,100.00
1090529,00792B,群益A級公司債,311115,307115,4000,1.30,100.00
1090529,00793B,群益AAA-A醫療債,4526,4526,0,0.00,100.00
1090529,00794B,群益7+中國政金債,381687,381687,0,0.00,100.00
1090529,00795B,中信美國公債20年,299598,278098,21500,7.73,94.03
1090529,00796B,中信中國債7-10,107970,107970,0,0.00,100.00
1090529,00798B,國泰中企A級債7+,1071,1571,-500,-31.82,100.00
1090529,00799B,國泰A級醫療債,12036,12036,0,0.00,100.00
1090529,00831B,新光美債1-3,107100,107100,0,0.00,100.00
1090529,00832B,新光美債20+,5300,5300,0,0.00,100.00
1090529,00833B,第一金美債20+,5081,5081,0,0.00,100.00
1090529,00834B,第一金金融債10+,30198,30198,0,0.00,100.00
1090529,00835B,第一金科技債10+,691,691,0,0.00,100.00
1090529,00836B,永豐10年A公司債,234541,234541,0,0.00,100.00
1090529,00837B,永豐15年金融債,1041,1041,0,0.00,100.00
1090529,00838B,永豐7-10年中國債,16691,16691,0,0.00,100.00
1090529,00839B,凱基醫療保健債,32941,28941,4000,13.82,100.00
1090529,00840B,凱基IG精選15+,32431,35931,-3500,-9.74,100.00
1090529,00841B,凱基AAA-AA公司債,33940,33940,0,0.00,100.00
1090529,00842B,台新美元銀行債,32767,33267,-500,-1.50,100.00
1090529,00843B,台新中國政策債,6021,6021,0,0.00,100.00
1090529,00844B,新光15年IG金融債,41175,41175,0,0.00,100.00
1090529,00845B,富邦新興投等債,54551,54551,0,0.00,100.00
1090529,00846B,富邦歐洲銀行債,111350,111350,0,0.00,100.00
1090529,00847B,中信美國市政債,14805,14805,0,0.00,100.00
1090529,00848B,中信新興亞洲債,378566,378066,500,0.13,100.00
1090529,00849B,中信EM主權債0-5,704606,704606,0,0.00,100.00
1090529,00853B,統一美債10年Aa-A,4634,4634,0,0.00,100.00
1090529,00854B,富邦全球保險債,454,454,0,0.00,100.00
1090529,00855B,富邦全球能源債,683,683,0,0.00,100.00
1090529,00856B,永豐1-3年美公債,19292,44792,-25500,-56.92,100.00
1090529,00857B,永豐20年美公債,7768,7768,0,0.00,100.00
1090529,00858 ,永豐美國500大,531374,531374,0,0.00,100.00
1090529,00859B,群益0-1年美債,12011,12011,0,0.00,100.00
1090529,00860B,群益1-5年IG債,35171,35171,0,0.00,100.00
1090529,00862B,中信投資級公司債,33881,33881,0,0.00,100.00
1090529,00863B,中信全球電信債,100964,100964,0,0.00,100.00
1090529,00864B,中信美國公債0-1,15222,27722,-12500,-45.09,100.00
1090529,00867B,新光A-BBB電信債,38650,38650,0,0.00,100.00
1090529,00868B,FT1-3年美公債,5324,5324,0,0.00,100.00
1090529,00869B,FT10-25年公司債,6282,6282,0,0.00,100.00
1090529,00870B,元大15年EM主權債,224651,199151,25500,12.80,100.00
1090529,00871B,元大中國政金債,3570,3570,0,0.00,100.00
1090529,00872B,凱基美債1-3,5110,5110,0,0.00,100.00
1090529,00873B,凱基新興債1-5,1877,2377,-500,-21.03,100.00
1090529,00874B,凱基BBB公司債15+,16290,16290,0,0.00,100.00
1090529,020001,富邦存股雙十N,40000,40000,0,0.00,100.00
1090529,020003,統一漲升股利150N,20000,20000,0,0.00,100.00
1090529,020009,群益A50綠碳N,10000,10000,0,0.00,100.00
1090529,020010,永昌富櫃200N,20000,20000,0,0.00,100.00
1090529,020013,元富亞洲高股息N,20000,20000,0,0.00,100.00
1090529,020014,元大富櫃200N,60000,60000,0,0.00,100.00
1090529,1240  ,茂生農經,33990,33990,0,0.00,100.00
1090529,1258  ,其祥-KY,36819,36819,0,0.00,100.00
1090529,12582 ,其祥二KY,2999,2999,0,0.00,99.96
1090529,1259  ,安心,32389,32389,0,0.00,100.00
1090529,1264  ,德麥,33695,33695,0,0.00,100.00
1090529,1268  ,漢來美食,37723,37723,0,0.00,100.00
1090529,13163 ,上曜三,4556,4556,0,0.00,91.12
1090529,1333  ,恩得利,51060,51060,0,0.00,100.00
1090529,1336  ,台翰,77098,77098,0,0.00,100.00
1090529,14361 ,華友聯一,3000,3000,0,0.00,100.00
1090529,14423 ,名軒三,6389,6389,0,0.00,79.86
1090529,14721 ,三洋紡一,2889,2889,0,0.00,96.30
1090529,15131 ,中興電一,15000,15000,0,0.00,100.00
1090529,1565  ,精華,50416,50416,0,0.00,100.00
1090529,1569  ,濱川,113443,113443,0,0.00,100.00
1090529,15696 ,濱川六,1832,1832,0,0.00,91.60
1090529,1570  ,力肯,51500,51500,0,0.00,100.00
1090529,1580  ,新麥,50230,50230,0,0.00,100.00
1090529,1584  ,精剛,82470,82470,0,0.00,100.00
1090529,1586  ,和勤,80151,80151,0,0.00,100.00
1090529,15892 ,永冠二KY,64,64,0,0.00,0.25
1090529,1591  ,駿吉-KY,33164,33164,0,0.00,100.00
1090529,15921 ,英瑞一KY,2000,2000,0,0.00,100.00
1090529,1593  ,祺驊,31948,31948,0,0.00,100.00
1090529,1595  ,川寶,47148,47148,0,0.00,100.00
1090529,1597  ,直得,81187,81187,0,0.00,100.00
1090529,15981 ,岱宇一,4956,5985,-1029,-17.19,82.60
1090529,1599  ,宏佳騰,73458,73458,0,0.00,100.00
1090529,16262 ,艾美特二KY,4432,4432,0,0.00,88.64
1090529,16263 ,艾美特三KY,3000,3000,0,0.00,100.00
1090529,17333 ,五鼎三,3918,3918,0,0.00,97.95
1090529,1742  ,台蠟,41461,41461,0,0.00,100.00
1090529,1752  ,南光,100988,100988,0,0.00,100.00
1090529,1777  ,生泰,30059,30059,0,0.00,100.00
1090529,1781  ,合世,47407,47407,0,0.00,100.00
1090529,1784  ,訊聯,49626,49626,0,0.00,100.00
1090529,1785  ,光洋科,397431,397431,0,0.00,100.00
1090529,17861 ,科妍一,3000,3000,0,0.00,100.00
1090529,1788  ,杏昌,36000,36000,0,0.00,100.00
1090529,17881 ,杏昌一,4200,4200,0,0.00,100.00
1090529,1796  ,金穎生技,27893,27893,0,0.00,100.00
1090529,17961 ,金穎生技一,3000,3000,0,0.00,100.00
1090529,1799  ,易威,57517,57517,0,0.00,100.00
1090529,1813  ,寶利徠,46635,46635,0,0.00,100.00
1090529,1815  ,富喬,422946,422946,0,0.00,100.00
1090529,18155 ,富喬五,6000,6000,0,0.00,100.00
1090529,20067 ,東和鋼鐵七,20000,20000,0,0.00,100.00
1090529,20315 ,新光鋼五,4398,4398,0,0.00,73.30
1090529,2035  ,唐榮,350000,350000,0,0.00,100.00
1090529,2061  ,風青,58660,58660,0,0.00,100.00
1090529,2063  ,世鎧,45000,45000,0,0.00,100.00
1090529,20631 ,世鎧一,3000,3000,0,0.00,100.00
1090529,2064  ,晉椿,69630,69630,0,0.00,100.00
1090529,2065  ,世豐,32919,32919,0,0.00,100.00
1090529,20651 ,世豐一,3888,3888,0,0.00,97.20
1090529,2066  ,世德,36502,36502,0,0.00,100.00
1090529,2067  ,嘉鋼,45138,45138,0,0.00,100.00
1090529,20693 ,運錩三,3998,3998,0,0.00,99.95
1090529,2070  ,精湛,35782,35782,0,0.00,100.00
1090529,22081 ,台船一,20000,20000,0,0.00,100.00
1090529,2221  ,大甲,42325,42325,0,0.00,100.00
1090529,2230  ,泰茂,39913,39913,0,0.00,100.00
1090529,2235  ,謚源,35878,35878,0,0.00,100.00
1090529,22392 ,英利二KY,4000,4000,0,0.00,100.00
1090529,22431 ,宏旭一KY,3589,3589,0,0.00,89.72
1090529,233201,友訊Ｅ１,2953,2953,0,0.00,24.60
1090529,23834 ,台光電四,14254,14254,0,0.00,95.02
1090529,24064 ,國碩四,12000,12000,0,0.00,100.00
1090529,24392 ,美律二,22895,22895,0,0.00,76.31
1090529,24564 ,奇力新四,4,4,0,0.00,0.02
1090529,24565 ,奇力新五,1422,1422,0,0.00,10.15
1090529,24566 ,奇力新六,13579,13579,0,0.00,67.89
1090529,24663 ,冠西三,3000,3000,0,0.00,100.00
1090529,24722 ,立隆電二,6000,6000,0,0.00,100.00
1090529,24921 ,華新科一,48000,48000,0,0.00,100.00
1090529,25282 ,皇普二,7000,7000,0,0.00,100.00
1090529,25355 ,達欣工五,3155,3155,0,0.00,31.55
1090529,25391 ,櫻花建一,2000,2000,0,0.00,100.00
1090529,25392 ,櫻花建二,1497,1497,0,0.00,51.26
1090529,25425 ,興富發五,99999,99999,0,0.00,99.99
1090529,2596  ,綠意,100000,100000,0,0.00,100.00
1090529,26095 ,陽明五,76000,76000,0,0.00,100.00
1090529,26106 ,華航六,60000,60000,0,0.00,100.00
1090529,26183 ,長榮航三,65489,65489,0,0.00,93.55
1090529,26301 ,亞航一,2000,2000,0,0.00,100.00
1090529,26302 ,亞航二,3000,3000,0,0.00,100.00
1090529,26372 ,慧洋二KY,3972,3972,0,0.00,99.30
1090529,26373 ,慧洋三KY,1010,1010,0,0.00,12.62
1090529,2640  ,大車隊,53755,53755,0,0.00,100.00
1090529,2641  ,正德,151124,151124,0,0.00,100.00
1090529,26413 ,正德三,2500,2500,0,0.00,100.00
1090529,26414 ,正德四,1408,1408,0,0.00,46.93
1090529,2643  ,捷迅,30000,30000,0,0.00,100.00
1090529,27072 ,晶華二,13828,13828,0,0.00,92.18
1090529,2718  ,晶悅,42576,42576,0,0.00,100.00
1090529,2719  ,燦星旅,18272,18272,0,0.00,100.00
1090529,2724  ,富驛-KY,38172,38172,0,0.00,100.00
1090529,2726  ,雅茗-KY,34908,34908,0,0.00,100.00
1090529,2729  ,瓦城,23266,23266,0,0.00,100.00
1090529,27291 ,瓦城一,8000,8000,0,0.00,100.00
1090529,2732  ,六角,40642,40642,0,0.00,100.00
1090529,27322 ,六角二,3327,3327,0,0.00,73.93
1090529,2734  ,易飛網,30259,30259,0,0.00,100.00
1090529,2736  ,高野,48992,48992,0,0.00,100.00
1090529,2740  ,天蔥,8613,8613,0,0.00,100.00
1090529,2743  ,山富,32031,32031,0,0.00,100.00
1090529,2745  ,五福,29308,29308,0,0.00,100.00
1090529,27481 ,雲品一,8000,8000,0,0.00,100.00
1090529,2752  ,豆府,21872,21872,0,0.00,100.00
1090529,28885 ,新光金四,15039,15039,0,0.00,37.59
1090529,28886 ,新光金五,50000,50000,0,0.00,100.00
1090529,2916  ,滿心,54626,54626,0,0.00,100.00
1090529,2924  ,東凌-KY,32805,32805,0,0.00,100.00
1090529,2926  ,誠品生活,47389,47389,0,0.00,100.00
1090529,2928  ,紅馬-KY,47301,47301,0,0.00,100.00
1090529,2937  ,集雅社,32860,32860,0,0.00,100.00
1090529,30163 ,嘉晶三,6000,6000,0,0.00,100.00
1090529,30183 ,同開三,892,892,0,0.00,44.60
1090529,30366 ,文曄六,6700,7131,-431,-6.04,55.83
1090529,30453 ,台灣大三,9283,9283,0,0.00,9.28
1090529,3064  ,泰偉,72105,72105,0,0.00,100.00
1090529,3066  ,李洲,77570,77570,0,0.00,100.00
1090529,3067  ,全域,29025,29025,0,0.00,100.00
1090529,3071  ,協禧,110000,110000,0,0.00,100.00
1090529,3073  ,凱柏,12596,12596,0,0.00,100.00
1090529,3078  ,僑威,227391,227391,0,0.00,100.00
1090529,3081  ,聯亞,90932,90932,0,0.00,100.00
1090529,3083  ,網龍,85704,85704,0,0.00,100.00
1090529,3085  ,新零售,49004,49004,0,0.00,100.00
1090529,3086  ,華義,6836,6836,0,0.00,100.00
1090529,3088  ,艾訊,82041,82041,0,0.00,100.00
1090529,30881 ,艾訊一,3131,3131,0,0.00,74.54
1090529,3089  ,元炬,29620,29620,0,0.00,100.00
1090529,3092  ,鴻碩,74562,74562,0,0.00,100.00
1090529,3093  ,港建,36288,36288,0,0.00,100.00
1090529,3095  ,及成,90060,90060,0,0.00,100.00
1090529,3105  ,穩懋,404056,404056,0,0.00,100.00
1090529,3114  ,好德,56000,56000,0,0.00,100.00
1090529,3115  ,寶島極,20697,20697,0,0.00,100.00
1090529,3118  ,進階,32452,32452,0,0.00,100.00
1090529,3122  ,笙泉,38299,38299,0,0.00,100.00
1090529,3128  ,昇銳,42000,42000,0,0.00,100.00
1090529,3131  ,弘塑,29216,29216,0,0.00,100.00
1090529,3141  ,晶宏,63917,63917,0,0.00,100.00
1090529,3144  ,新揚科,100637,100637,0,0.00,100.00
1090529,3147  ,大綜,34006,34006,0,0.00,100.00
1090529,3152  ,璟德,69016,69016,0,0.00,100.00
1090529,3162  ,精確,56531,56531,0,0.00,100.00
1090529,3163  ,波若威,75286,75286,0,0.00,100.00
1090529,3169  ,亞信,54440,54440,0,0.00,100.00
1090529,3171  ,新洲,39203,39203,0,0.00,100.00
1090529,3176  ,基亞,138985,138985,0,0.00,100.00
1090529,3178  ,公準,45050,45050,0,0.00,100.00
1090529,3188  ,鑫龍騰,120295,120295,0,0.00,100.00
1090529,31881 ,鑫龍騰一,3000,3000,0,0.00,100.00
1090529,3191  ,和進,54694,54694,0,0.00,100.00
1090529,3202  ,樺晟,117164,117164,0,0.00,100.00
1090529,3205  ,佰研,32772,32772,0,0.00,100.00
1090529,3206  ,志豐,53916,53916,0,0.00,100.00
1090529,3207  ,耀勝,39520,39520,0,0.00,100.00
1090529,32093 ,全科三,1607,1607,0,0.00,53.56
1090529,3211  ,順達科,147480,147480,0,0.00,100.00
1090529,3213  ,茂訊,58685,58685,0,0.00,100.00
1090529,3217  ,優群,82104,82104,0,0.00,100.00
1090529,3218  ,大學光,76123,76123,0,0.00,100.00
1090529,3219  ,倚強,10723,10723,0,0.00,100.00
1090529,3221  ,台嘉碩,96322,96322,0,0.00,100.00
1090529,3224  ,三顧,58016,58016,0,0.00,100.00
1090529,32243 ,三顧三,1500,1500,0,0.00,100.00
1090529,3226  ,至寶電,64430,64430,0,0.00,100.00
1090529,3227  ,原相,139396,139396,0,0.00,100.00
1090529,3228  ,金麗科,62758,62758,0,0.00,100.00
1090529,3230  ,錦明,107746,107746,0,0.00,100.00
1090529,3232  ,昱捷,36567,36567,0,0.00,100.00
1090529,3234  ,光環,75988,75988,0,0.00,100.00
1090529,3236  ,千如,84852,84852,0,0.00,100.00
1090529,3252  ,海灣,50195,50195,0,0.00,100.00
1090529,3259  ,鑫創,67633,67633,0,0.00,100.00
1090529,3260  ,威剛,227518,227518,0,0.00,100.00
1090529,32606 ,威剛六,10932,10932,0,0.00,72.88
1090529,3264  ,欣銓,490259,490259,0,0.00,100.00
1090529,3265  ,台星科,136261,136261,0,0.00,100.00
1090529,3268  ,海德威,33426,33426,0,0.00,100.00
1090529,3272  ,東碩,52264,52264,0,0.00,100.00
1090529,32722 ,東碩二,4000,4000,0,0.00,100.00
1090529,3276  ,宇環,69712,69712,0,0.00,100.00
1090529,3284  ,太普高,55961,55961,0,0.00,100.00
1090529,3285  ,微端,44109,44109,0,0.00,100.00
1090529,3287  ,廣寰科,43970,43970,0,0.00,100.00
1090529,3288  ,點晶,19390,19390,0,0.00,100.00
1090529,3289  ,宜特,92975,92975,0,0.00,100.00
1090529,32895 ,宜特五,14551,14551,0,0.00,97.00
1090529,3290  ,東浦,99548,99548,0,0.00,100.00
1090529,3293  ,鈊象,70450,70450,0,0.00,100.00
1090529,3294  ,英濟,132015,132015,0,0.00,100.00
1090529,3297  ,杭特,36839,36839,0,0.00,100.00
1090529,3303  ,岱稜,96089,96089,0,0.00,100.00
1090529,3306  ,鼎天,50607,50607,0,0.00,100.00
1090529,3310  ,佳穎,50225,50225,0,0.00,100.00
1090529,3313  ,斐成,60390,60390,0,0.00,100.00
1090529,3317  ,尼克森,61251,61251,0,0.00,100.00
1090529,3322  ,建舜電,96651,96651,0,0.00,100.00
1090529,3323  ,加百裕,83305,83305,0,0.00,100.00
1090529,3324  ,雙鴻,86545,86545,0,0.00,100.00
1090529,33243 ,雙鴻三,2385,2385,0,0.00,39.75
1090529,3325  ,旭品,72252,72252,0,0.00,100.00
1090529,3332  ,幸康,48104,48104,0,0.00,100.00
1090529,33382 ,泰碩二,2481,2481,0,0.00,82.70
1090529,3339  ,泰谷,61943,61943,0,0.00,100.00
1090529,33461 ,麗清一,63,63,0,0.00,0.90
1090529,33462 ,麗清二,3500,3500,0,0.00,100.00
1090529,3354  ,律勝,70112,70112,0,0.00,100.00
1090529,3360  ,尚立,68831,68831,0,0.00,100.00
1090529,3362  ,先進光,111545,111545,0,0.00,100.00
1090529,3363  ,上詮,90595,90595,0,0.00,100.00
1090529,33632 ,上詮二,493,493,0,0.00,12.32
1090529,3372  ,典範,146087,146087,0,0.00,100.00
1090529,3373  ,熱映,43289,43289,0,0.00,100.00
1090529,3374  ,精材,271364,271364,0,0.00,100.00
1090529,3379  ,彬台,38041,38041,0,0.00,100.00
1090529,3388  ,崇越電,74061,74061,0,0.00,100.00
1090529,3390  ,旭軟,67505,67505,0,0.00,100.00
1090529,3402  ,漢科,73047,73047,0,0.00,100.00
1090529,34131 ,京鼎一,10000,10000,0,0.00,100.00
1090529,3426  ,台興,26400,26400,0,0.00,100.00
1090529,3434  ,哲固,22700,22700,0,0.00,100.00
1090529,3438  ,類比科,67379,67379,0,0.00,100.00
1090529,3441  ,聯一光,40039,40039,0,0.00,100.00
1090529,3444  ,利機,39114,39114,0,0.00,100.00
1090529,3455  ,由田,61468,61468,0,0.00,100.00
1090529,3465  ,進泰電子,9660,9660,0,0.00,100.00
1090529,3466  ,致振,60887,60887,0,0.00,100.00
1090529,3479  ,安勤,70194,70194,0,0.00,100.00
1090529,3483  ,力致,61027,61027,0,0.00,100.00
1090529,34832 ,力致二,2000,2000,0,0.00,100.00
1090529,3484  ,崧騰,69736,69736,0,0.00,100.00
1090529,3489  ,森寶,83130,83130,0,0.00,100.00
1090529,3490  ,單井,57006,57006,0,0.00,100.00
1090529,3491  ,昇達科,60863,60863,0,0.00,100.00
1090529,3492  ,長盛,35531,35531,0,0.00,100.00
1090529,3498  ,陽程,54373,54373,0,0.00,100.00
1090529,3499  ,環天科,54970,54970,0,0.00,100.00
1090529,3508  ,位速,97267,97267,0,0.00,100.00
1090529,3511  ,矽瑪,49972,49972,0,0.00,100.00
1090529,3512  ,皇龍,44000,44000,0,0.00,100.00
1090529,3516  ,亞帝歐,50590,50590,0,0.00,100.00
1090529,3520  ,振維,26900,26900,0,0.00,100.00
1090529,3521  ,鴻翊,31730,31730,0,0.00,100.00
1090529,3522  ,御頂,46900,46900,0,0.00,100.00
1090529,3523  ,迎輝,48049,48049,0,0.00,100.00
1090529,3526  ,凡甲,72047,72047,0,0.00,100.00
1090529,35264 ,凡甲四,6000,6000,0,0.00,100.00
1090529,3527  ,聚積,40945,40945,0,0.00,100.00
1090529,3529  ,力旺,75833,75833,0,0.00,100.00
1090529,3531  ,先益,61175,61175,0,0.00,100.00
1090529,3537  ,堡達,48695,48695,0,0.00,100.00
1090529,3540  ,曜越,66613,66613,0,0.00,100.00
1090529,3541  ,西柏,49321,49321,0,0.00,100.00
1090529,3546  ,宇峻,41747,41747,0,0.00,100.00
1090529,3548  ,兆利,60121,60121,0,0.00,100.00
1090529,3551  ,世禾,56774,56774,0,0.00,100.00
1090529,3552  ,同致,85592,85592,0,0.00,100.00
1090529,3555  ,重鵬,19311,19311,0,0.00,100.00
1090529,3556  ,禾瑞亞,59468,59468,0,0.00,100.00
1090529,3558  ,神準,49060,49060,0,0.00,100.00
1090529,3564  ,其陽,23123,23123,0,0.00,100.00
1090529,3567  ,逸昌,34127,34127,0,0.00,100.00
1090529,3570  ,大塚,17097,17097,0,0.00,100.00
1090529,3577  ,泓格,52864,52864,0,0.00,100.00
1090529,3580  ,友威科,39470,39470,0,0.00,100.00
1090529,3581  ,博磊,51006,51006,0,0.00,100.00
1090529,3587  ,閎康,62313,62313,0,0.00,100.00
1090529,3594  ,磐儀,57733,57733,0,0.00,100.00
1090529,35942 ,磐儀二,1173,1173,0,0.00,58.65
1090529,35943 ,磐儀三,3000,3000,0,0.00,100.00
1090529,35961 ,智易一,10000,10000,0,0.00,100.00
1090529,3597  ,映興,35146,35146,0,0.00,100.00
1090529,3609  ,東林,30679,30679,0,0.00,100.00
1090529,3611  ,鼎翰,42476,42476,0,0.00,100.00
1090529,3615  ,安可,68466,68466,0,0.00,100.00
1090529,36171 ,碩天一,12000,12000,0,0.00,100.00
1090529,3623  ,富晶通,29209,29263,-54,-0.18,99.81
1090529,3624  ,光頡,117340,117340,0,0.00,100.00
1090529,3625  ,西勝,78296,78296,0,0.00,100.00
1090529,36252 ,西勝二,52,948,-896,-94.51,1.30
1090529,3628  ,盈正,45000,45000,0,0.00,100.00
1090529,3629  ,地心引力,7434,7434,0,0.00,100.00
1090529,3630  ,新鉅科,127904,128040,-136,-0.10,100.00
1090529,3631  ,晟楠,79920,79920,0,0.00,100.00
1090529,3632  ,研勤,58089,58089,0,0.00,100.00
1090529,3642  ,駿熠電,30368,30368,0,0.00,100.00
1090529,3646  ,艾恩特,39297,39297,0,0.00,100.00
1090529,3652  ,精聯,47097,47097,0,0.00,100.00
1090529,3663  ,鑫科,58956,58956,0,0.00,100.00
1090529,3664  ,安瑞-KY,51098,51098,0,0.00,100.00
1090529,3666  ,光耀,48299,48299,0,0.00,100.00
1090529,3672  ,康聯訊,32668,32668,0,0.00,100.00
1090529,3675  ,德微,44428,44428,0,0.00,100.00
1090529,3680  ,家登,74060,74060,0,0.00,100.00
1090529,36802 ,家登二,2505,3000,-495,-16.50,83.50
1090529,3684  ,榮昌,24591,24591,0,0.00,100.00
1090529,3685  ,元創精密,79990,79990,0,0.00,100.00
1090529,3687  ,歐買尬,30059,30059,0,0.00,100.00
1090529,3689  ,湧德,69675,69675,0,0.00,100.00
1090529,36892 ,湧德二,2913,2913,0,0.00,97.10
1090529,3691  ,碩禾,60989,60989,0,0.00,100.00
1090529,36912 ,碩禾二,18739,18739,0,0.00,93.69
1090529,3693  ,營邦,38490,38490,0,0.00,100.00
1090529,3707  ,漢磊,296036,296036,0,0.00,100.00
1090529,37072 ,漢磊二,4515,4515,0,0.00,60.20
1090529,3709  ,鑫聯大投控,79569,79569,0,0.00,100.00
1090529,3710  ,連展投控,207290,207290,0,0.00,100.00
1090529,37101 ,連展投控一,3000,3000,0,0.00,100.00
1090529,3713  ,新晶投控,72590,72590,0,0.00,100.00
1090529,4102  ,永日,42373,42373,0,0.00,100.00
1090529,4105  ,東洋,248649,248649,0,0.00,100.00
1090529,4107  ,邦特,69298,69298,0,0.00,100.00
1090529,4109  ,加捷生醫,67134,67134,0,0.00,100.00
1090529,4111  ,濟生,56982,56982,0,0.00,100.00
1090529,4113  ,聯上,211138,211138,0,0.00,100.00
1090529,4114  ,健喬,244168,244168,0,0.00,100.00
1090529,4116  ,明基醫,44566,44566,0,0.00,100.00
1090529,4120  ,友華,86747,86747,0,0.00,100.00
1090529,4121  ,優盛,73316,73316,0,0.00,100.00
1090529,4123  ,晟德,392272,392272,0,0.00,100.00
1090529,41233 ,晟德三,7273,7273,0,0.00,21.39
1090529,4126  ,太醫,66015,66015,0,0.00,100.00
1090529,4127  ,天良,45760,45760,0,0.00,100.00
1090529,4128  ,中天,425342,425342,0,0.00,100.00
1090529,4129  ,聯合,80420,80420,0,0.00,100.00
1090529,41292 ,聯合二,4000,4000,0,0.00,100.00
1090529,41293 ,聯合三,5000,5000,0,0.00,100.00
1090529,4130  ,健亞,105814,105814,0,0.00,100.00
1090529,4131  ,晶宇,27983,27983,0,0.00,100.00
1090529,4138  ,曜亞,30000,30000,0,0.00,100.00
1090529,4139  ,馬光-KY,41962,41962,0,0.00,100.00
1090529,41412 ,龍燈二KY,160,160,0,0.00,5.33
1090529,41414 ,龍燈四KY,3000,3000,0,0.00,100.00
1090529,41415 ,龍燈五KY,2991,2991,0,0.00,99.70
1090529,41421 ,國光一,1857,1857,0,0.00,30.95
1090529,41422 ,國光二,2588,2588,0,0.00,28.75
1090529,4147  ,中裕,252198,252198,0,0.00,100.00
1090529,4152  ,台微體,69477,69477,0,0.00,100.00
1090529,4153  ,鈺緯,49366,49366,0,0.00,100.00
1090529,4154  ,康樂-KY,19526,19526,0,0.00,100.00
1090529,41551 ,訊映一,1341,1341,0,0.00,53.64
1090529,4157  ,太景＊-KY,716840,716840,0,0.00,100.00
1090529,4160  ,創源,24247,24247,0,0.00,100.00
1090529,4161  ,聿新科,52659,52659,0,0.00,100.00
1090529,4162  ,智擎,146666,146666,0,0.00,100.00
1090529,4163  ,鐿鈦,40241,40241,0,0.00,100.00
1090529,41643 ,承業醫三,11697,11697,0,0.00,97.47
1090529,4167  ,展旺,268394,268394,0,0.00,100.00
1090529,41671 ,展旺一,6500,6500,0,0.00,92.85
1090529,41672 ,展旺二,7000,0,7000,0.00,100.00
1090529,4168  ,醣聯,78874,78874,0,0.00,100.00
1090529,41682 ,醣聯二,3000,3000,0,0.00,100.00
1090529,4171  ,瑞基,40590,40590,0,0.00,100.00
1090529,4173  ,久裕,74574,74574,0,0.00,100.00
1090529,4174  ,浩鼎,188228,188228,0,0.00,100.00
1090529,4175  ,杏一,31612,31612,0,0.00,100.00
1090529,41752 ,杏一二,3000,3000,0,0.00,100.00
1090529,4183  ,褔永生技,23800,23800,0,0.00,100.00
1090529,4188  ,安克,53221,53221,0,0.00,100.00
1090529,41901 ,佐登一KY,7500,7500,0,0.00,100.00
1090529,4192  ,杏國,69867,69867,0,0.00,100.00
1090529,4198  ,環瑞醫,42540,42540,0,0.00,100.00
1090529,4205  ,中華食,80701,80701,0,0.00,100.00
1090529,4207  ,環泰,172928,172928,0,0.00,100.00
1090529,4303  ,信立,70000,70000,0,0.00,100.00
1090529,4304  ,勝昱,13736,13736,0,0.00,100.00
1090529,4305  ,世&#22531;,55014,55014,0,0.00,100.00
1090529,43068 ,炎洲八,5000,5000,0,0.00,100.00
1090529,43069 ,炎洲九,5000,5000,0,0.00,100.00
1090529,4401  ,東隆興,120286,120286,0,0.00,100.00
1090529,4402  ,福大,45991,45991,0,0.00,100.00
1090529,4406  ,新昕纖,51912,51912,0,0.00,100.00
1090529,4413  ,飛寶企業,10364,10364,0,0.00,100.00
1090529,4416  ,三圓,60015,60015,0,0.00,100.00
1090529,44162 ,三圓二,10000,10000,0,0.00,100.00
1090529,4417  ,金洲,83971,83971,0,0.00,100.00
1090529,4419  ,元勝,14728,14728,0,0.00,100.00
1090529,4420  ,光明,40455,40455,0,0.00,100.00
1090529,4429  ,聚紡,34350,34350,0,0.00,100.00
1090529,4430  ,耀億,55073,55073,0,0.00,100.00
1090529,4432  ,銘旺實,50589,50589,0,0.00,100.00
1090529,4433  ,興采,46400,46400,0,0.00,100.00
1090529,44331 ,興采一,132,132,0,0.00,5.28
1090529,44381 ,廣越一,15000,15000,0,0.00,100.00
1090529,4502  ,健信,49768,49768,0,0.00,100.00
1090529,4503  ,金雨,23903,23903,0,0.00,100.00
1090529,4506  ,崇友,177012,177012,0,0.00,100.00
1090529,4510  ,高鋒,108010,108010,0,0.00,100.00
1090529,4513  ,福裕,76880,76880,0,0.00,100.00
1090529,4523  ,永彰,64000,64000,0,0.00,100.00
1090529,4527  ,&#22531;霖,76152,76152,0,0.00,100.00
1090529,4528  ,江興鍛,76514,76514,0,0.00,100.00
1090529,4529  ,淳紳,49847,49981,-134,-0.26,100.00
1090529,4530  ,宏易,32412,32412,0,0.00,100.00
1090529,4533  ,協易機,158434,158434,0,0.00,100.00
1090529,4534  ,慶騰,89193,89193,0,0.00,100.00
1090529,4535  ,至興,75661,75661,0,0.00,100.00
1090529,4538  ,大詠城,47600,47600,0,0.00,100.00
1090529,4541  ,晟田,69499,69499,0,0.00,100.00
1090529,45414 ,晟田四,1854,1854,0,0.00,92.70
1090529,4542  ,科嶠,28285,28285,0,0.00,100.00
1090529,4543  ,萬在,56970,56970,0,0.00,100.00
1090529,4549  ,桓達,42383,42383,0,0.00,100.00
1090529,4550  ,長佳,37096,37096,0,0.00,100.00
1090529,45511 ,智伸科一,15000,15000,0,0.00,100.00
1090529,4554  ,橙的,21374,21374,0,0.00,100.00
1090529,45551 ,氣立一,4616,5995,-1379,-23.00,76.93
1090529,45552 ,氣立二,6000,6000,0,0.00,100.00
1090529,4556  ,旭然,41742,41742,0,0.00,100.00
1090529,45601 ,強信一KY,1762,1762,0,0.00,58.73
1090529,4561  ,健椿,58521,58521,0,0.00,100.00
1090529,4563  ,百德,54950,54950,0,0.00,100.00
1090529,45631 ,百德一,2000,2000,0,0.00,100.00
1090529,45661 ,時碩工業一,6000,6000,0,0.00,100.00
1090529,4568  ,科際精密,30246,30246,0,0.00,100.00
1090529,4580  ,捷流閥業,39132,39132,0,0.00,100.00
1090529,4609  ,唐鋒,47946,47946,0,0.00,100.00
1090529,4702  ,中美實,72333,72333,0,0.00,100.00
1090529,47031 ,揚華一,2997,2997,0,0.00,99.90
1090529,4706  ,大恭,79030,79030,0,0.00,100.00
1090529,4707  ,磐亞,286567,286567,0,0.00,100.00
1090529,4711  ,永純,61056,61056,0,0.00,100.00
1090529,4712  ,南璋,41569,41569,0,0.00,100.00
1090529,4714  ,永捷,103593,103593,0,0.00,100.00
1090529,47145 ,永捷五,2894,2894,0,0.00,96.46
1090529,4716  ,大立,75171,75171,0,0.00,100.00
1090529,47162 ,大立二,2000,2000,0,0.00,100.00
1090529,47202 ,德淵二,2000,2000,0,0.00,100.00
1090529,47203 ,德淵三,929,929,0,0.00,92.90
1090529,4721  ,美琪瑪,74986,74986,0,0.00,100.00
1090529,4726  ,永昕,109954,109954,0,0.00,100.00
1090529,4728  ,雙美,54463,54463,0,0.00,100.00
1090529,4729  ,熒茂,84667,84667,0,0.00,100.00
1090529,4735  ,豪展,37555,37555,0,0.00,100.00
1090529,47352 ,豪展二,92,92,0,0.00,4.60
1090529,4736  ,泰博,84294,84294,0,0.00,100.00
1090529,47363 ,泰博三,8252,15000,-6748,-44.98,55.01
1090529,4741  ,泓瀚,32841,32841,0,0.00,100.00
1090529,4743  ,合一,353117,353117,0,0.00,100.00
1090529,4744  ,皇將,46995,46995,0,0.00,100.00
1090529,47441 ,皇將一,3000,3000,0,0.00,100.00
1090529,4745  ,合富-KY,73761,73761,0,0.00,100.00
1090529,47463 ,台耀三,7000,7000,0,0.00,100.00
1090529,4747  ,強生,30018,30018,0,0.00,100.00
1090529,4754  ,國碳科,18761,18761,0,0.00,100.00
1090529,4760  ,勤凱,29500,29500,0,0.00,100.00
1090529,47631 ,材料一KY,5000,5000,0,0.00,100.00
1090529,47641 ,雙鍵一,6000,6000,0,0.00,100.00
1090529,4767  ,誠泰科技,31415,31415,0,0.00,100.00
1090529,4803  ,VHQ-KY,39379,39379,0,0.00,100.00
1090529,48032 ,VHQ二KY,5000,5000,0,0.00,100.00
1090529,4804  ,大略-KY,36031,36031,0,0.00,100.00
1090529,48041 ,大略一KY,6,6,0,0.00,0.15
1090529,4806  ,昇華,31824,31824,0,0.00,100.00
1090529,4903  ,聯光通,90279,90279,0,0.00,100.00
1090529,4905  ,台聯電,36822,36822,0,0.00,100.00
1090529,49065 ,正文五,12000,12000,0,0.00,100.00
1090529,4907  ,富宇,118145,118145,0,0.00,100.00
1090529,4908  ,前鼎,78216,78216,0,0.00,100.00
1090529,4909  ,新復興,93356,93356,0,0.00,100.00
1090529,4911  ,德英,55660,55660,0,0.00,100.00
1090529,49122 ,聯德控股二KY,5950,5950,0,0.00,99.16
1090529,49162 ,事欣科二,5000,5000,0,0.00,100.00
1090529,4924  ,欣厚-KY,37164,37164,0,0.00,100.00
1090529,49273 ,泰鼎三KY,1,1,0,0.00,0.01
1090529,4931  ,新盛力,61975,61975,0,0.00,100.00
1090529,4933  ,友輝,78254,78254,0,0.00,100.00
1090529,4939  ,亞電,98200,98200,0,0.00,100.00
1090529,49431 ,康控一KY,344,344,0,0.00,2.29
1090529,4944  ,兆遠,154955,154955,0,0.00,100.00
1090529,4946  ,辣椒,27320,27320,0,0.00,100.00
1090529,4950  ,牧東,45779,45779,0,0.00,100.00
1090529,4953  ,緯軟,66401,66401,0,0.00,100.00
1090529,4966  ,譜瑞-KY,80002,80002,0,0.00,100.00
1090529,49671 ,十銓一,5000,5000,0,0.00,100.00
1090529,4971  ,IET-KY,36532,36532,0,0.00,100.00
1090529,4972  ,湯石照明,40253,40253,0,0.00,100.00
1090529,4973  ,廣穎,63505,63505,0,0.00,100.00
1090529,4974  ,亞泰,72500,72500,0,0.00,100.00
1090529,4979  ,華星光,101030,101030,0,0.00,100.00
1090529,49792 ,華星光二,123,123,0,0.00,4.10
1090529,4987  ,科誠,25200,25200,0,0.00,100.00
1090529,4991  ,環宇-KY,91351,91351,0,0.00,100.00
1090529,4995  ,晶達,41774,41774,0,0.00,100.00
1090529,5009  ,榮剛,466735,466735,0,0.00,100.00
1090529,5011  ,久陽,41135,41135,0,0.00,100.00
1090529,50112 ,久陽二,1000,1000,0,0.00,100.00
1090529,50113 ,久陽三,1940,1940,0,0.00,97.00
1090529,5013  ,強新,133416,133416,0,0.00,100.00
1090529,5014  ,建錩,165333,165333,0,0.00,100.00
1090529,5015  ,華祺,60639,60639,0,0.00,100.00
1090529,5016  ,松和,49622,49622,0,0.00,100.00
1090529,5102  ,富強,64085,64085,0,0.00,100.00
1090529,5201  ,凱衛,30674,30674,0,0.00,100.00
1090529,5202  ,力新,59094,59094,0,0.00,100.00
1090529,5205  ,中茂,9710,9710,0,0.00,100.00
1090529,5206  ,坤悅,148500,148500,0,0.00,100.00
1090529,5209  ,新鼎,23495,23495,0,0.00,100.00
1090529,5210  ,寶碩,63699,63699,0,0.00,100.00
1090529,5211  ,蒙恬,32024,32024,0,0.00,100.00
1090529,5212  ,凌網,34633,34633,0,0.00,100.00
1090529,5213  ,亞昕,346195,346195,0,0.00,100.00
1090529,52137 ,亞昕七,10000,10000,0,0.00,100.00
1090529,5220  ,萬達光電,39667,39667,0,0.00,100.00
1090529,5223  ,安力-KY,43247,43247,0,0.00,100.00
1090529,5227  ,立凱-KY,195573,195573,0,0.00,100.00
1090529,5230  ,雷笛克光學,48955,48955,0,0.00,100.00
1090529,5245  ,智晶,44990,44990,0,0.00,100.00
1090529,5251  ,天鉞電,27844,27844,0,0.00,100.00
1090529,5263  ,智崴,55747,55747,0,0.00,100.00
1090529,5272  ,笙科,56424,56424,0,0.00,100.00
1090529,5274  ,信驊,32202,32202,0,0.00,100.00
1090529,5276  ,達輝-KY,39500,39500,0,0.00,100.00
1090529,5278  ,尚凡國際,15247,15247,0,0.00,100.00
1090529,5281  ,大峽谷－KY,37010,37010,0,0.00,100.00
1090529,52811 ,大峽谷一KY,2928,2958,-30,-1.01,97.60
1090529,52842 ,jpp二KY,2000,2000,0,0.00,100.00
1090529,52852 ,界霖二,6000,6000,0,0.00,100.00
1090529,5287  ,數字,42575,42575,0,0.00,100.00
1090529,5289  ,宜鼎,79729,79729,0,0.00,100.00
1090529,5291  ,邑昇,38824,38824,0,0.00,100.00
1090529,52911 ,邑昇一,543,543,0,0.00,54.30
1090529,5299  ,杰力,35228,35228,0,0.00,100.00
1090529,5301  ,寶得利,62540,62540,0,0.00,100.00
1090529,5302  ,太欣,162377,162377,0,0.00,100.00
1090529,5304  ,鼎創達,124789,124789,0,0.00,100.00
1090529,5306  ,桂盟,126000,126000,0,0.00,100.00
1090529,5309  ,系統電,151239,151219,20,0.01,100.00
1090529,5310  ,天剛,49601,49601,0,0.00,100.00
1090529,5312  ,寶島科,60059,60059,0,0.00,100.00
1090529,5314  ,世紀,60000,60000,0,0.00,100.00
1090529,5315  ,光聯,106351,106351,0,0.00,100.00
1090529,5321  ,友銓,32200,32200,0,0.00,100.00
1090529,5324  ,士開,136379,136379,0,0.00,100.00
1090529,5328  ,華容,172710,172710,0,0.00,100.00
1090529,5340  ,建榮,165893,165893,0,0.00,100.00
1090529,5344  ,立衛,79447,79447,0,0.00,100.00
1090529,5345  ,天揚,30000,30000,0,0.00,100.00
1090529,5347  ,世界,1638982,1638982,0,0.00,100.00
1090529,5348  ,系通,14250,14250,0,0.00,100.00
1090529,5349  ,先豐,224096,224096,0,0.00,100.00
1090529,5351  ,鈺創,435239,435239,0,0.00,100.00
1090529,5353  ,台林,75000,75000,0,0.00,100.00
1090529,5355  ,佳總,146960,146960,0,0.00,100.00
1090529,5356  ,協益,103040,103040,0,0.00,100.00
1090529,5364  ,力麗店,14099,14099,0,0.00,100.00
1090529,5371  ,中光電,434423,434423,0,0.00,100.00
1090529,5381  ,合正,118203,118203,0,0.00,100.00
1090529,5383  ,金利,49400,49400,0,0.00,100.00
1090529,5386  ,青雲,22474,22474,0,0.00,100.00
1090529,5392  ,應華,166631,166631,0,0.00,100.00
1090529,53924 ,應華四,10356,10356,0,0.00,69.04
1090529,5398  ,慕康生醫,33050,33050,0,0.00,100.00
1090529,5403  ,中菲,62630,62630,0,0.00,100.00
1090529,5410  ,國眾,85900,85900,0,0.00,100.00
1090529,5425  ,台半,242712,242712,0,0.00,100.00
1090529,54255 ,台半五,9032,9032,0,0.00,90.32
1090529,5426  ,振發,143800,143800,0,0.00,100.00
1090529,5432  ,達威,20687,20687,0,0.00,100.00
1090529,5438  ,東友,112536,112536,0,0.00,100.00
1090529,5439  ,高技,85975,85975,0,0.00,100.00
1090529,5443  ,均豪,165136,165136,0,0.00,100.00
1090529,5450  ,寶聯通,50392,50392,0,0.00,100.00
1090529,5452  ,佶優,148763,148763,0,0.00,100.00
1090529,5455  ,昇益,5501,5501,0,0.00,100.00
1090529,5457  ,宣德,169585,169585,0,0.00,100.00
1090529,5460  ,同協,61227,61227,0,0.00,100.00
1090529,5464  ,霖宏,71071,71071,0,0.00,100.00
1090529,5465  ,富驊,91354,91354,0,0.00,100.00
1090529,5468  ,凱鈺,7596,7596,0,0.00,100.00
1090529,5474  ,聰泰,33729,33729,0,0.00,100.00
1090529,5475  ,德宏,173610,173610,0,0.00,100.00
1090529,5478  ,智冠,127474,127474,0,0.00,100.00
1090529,5481  ,新華,74693,74693,0,0.00,100.00
1090529,5483  ,中美晶,586221,586221,0,0.00,100.00
1090529,5487  ,通泰,23636,23636,0,0.00,100.00
1090529,5488  ,松普,91586,91586,0,0.00,100.00
1090529,5489  ,彩富,102706,102706,0,0.00,100.00
1090529,5490  ,同亨,95826,95826,0,0.00,100.00
1090529,5493  ,三聯,44264,44264,0,0.00,100.00
1090529,5498  ,凱崴,148778,148778,0,0.00,100.00
1090529,5508  ,永信建,217428,217428,0,0.00,100.00
1090529,5511  ,德昌,113440,113440,0,0.00,100.00
1090529,5512  ,力麒,743992,743992,0,0.00,100.00
1090529,5514  ,三豐,176643,176643,0,0.00,100.00
1090529,5516  ,雙喜,38295,38295,0,0.00,100.00
1090529,5520  ,力泰,60315,60315,0,0.00,100.00
1090529,5523  ,豐謙,155001,155001,0,0.00,100.00
1090529,5529  ,志嘉,74200,74200,0,0.00,100.00
1090529,5530  ,龍巖,399084,399084,0,0.00,100.00
1090529,5536  ,聖暉,54186,54186,0,0.00,100.00
1090529,55381 ,東明一KY,4000,4000,0,0.00,100.00
1090529,5543  ,崇佑-KY,35699,35699,0,0.00,100.00
1090529,5601  ,台聯櫃,64800,64800,0,0.00,100.00
1090529,5603  ,陸海,78324,78324,0,0.00,100.00
1090529,5604  ,中連貨,108782,108782,0,0.00,100.00
1090529,5609  ,中菲行,126000,126000,0,0.00,100.00
1090529,5701  ,劍湖山,223761,223761,0,0.00,100.00
1090529,5703  ,亞都,70239,70239,0,0.00,100.00
1090529,5704  ,老爺知,38861,38861,0,0.00,100.00
1090529,5820  ,日盛金,3711819,3711819,0,0.00,100.00
1090529,5864  ,致和證,237490,237490,0,0.00,100.00
1090529,5878  ,台名,25024,25024,0,0.00,100.00
1090529,5902  ,德記,40551,40551,0,0.00,100.00
1090529,5903  ,全家,223220,223220,0,0.00,100.00
1090529,5904  ,寶雅,97685,97685,0,0.00,100.00
1090529,5905  ,南仁湖,189816,189816,0,0.00,100.00
1090529,6015  ,宏遠證,338200,338200,0,0.00,100.00
1090529,6016  ,康和證,590322,590322,0,0.00,100.00
1090529,6020  ,大展證,252353,252353,0,0.00,100.00
1090529,6021  ,大慶證,306755,306755,0,0.00,100.00
1090529,6023  ,元大期,249976,249976,0,0.00,100.00
1090529,6026  ,福邦證,245747,245747,0,0.00,100.00
1090529,6101  ,寬魚國際,59826,59826,0,0.00,100.00
1090529,6103  ,合邦,6576,6576,0,0.00,100.00
1090529,6104  ,創惟,90818,90818,0,0.00,100.00
1090529,6109  ,亞元,57400,57400,0,0.00,100.00
1090529,6111  ,大宇資,28247,28247,0,0.00,100.00
1090529,6113  ,亞矽,50047,50047,0,0.00,100.00
1090529,6114  ,久威,43911,43911,0,0.00,100.00
1090529,6118  ,建達,90889,90889,0,0.00,100.00
1090529,6121  ,新普,184970,184970,0,0.00,100.00
1090529,6122  ,擎邦,68729,68729,0,0.00,100.00
1090529,6123  ,上奇,59037,59037,0,0.00,100.00
1090529,6124  ,業強,182479,182479,0,0.00,100.00
1090529,6125  ,廣運,242011,242011,0,0.00,100.00
1090529,6126  ,信音,126839,131839,-5000,-3.79,100.00
1090529,6127  ,九豪,108079,108079,0,0.00,100.00
1090529,6129  ,普誠,180943,180943,0,0.00,100.00
1090529,6130  ,星寶國際,26600,26600,0,0.00,100.00
1090529,6134  ,萬旭,94270,94270,0,0.00,100.00
1090529,6138  ,茂達,73083,73083,0,0.00,100.00
1090529,6140  ,訊達,38367,38367,0,0.00,100.00
1090529,6143  ,振曜,83006,83006,0,0.00,100.00
1090529,6144  ,得利影,31696,31696,0,0.00,100.00
1090529,6146  ,耕興,92396,92396,0,0.00,100.00
1090529,6147  ,頎邦,654261,654261,0,0.00,100.00
1090529,6148  ,驊宏資,47000,47000,0,0.00,100.00
1090529,6150  ,撼訊,33290,33290,0,0.00,100.00
1090529,6151  ,晉倫,55257,55257,0,0.00,100.00
1090529,6154  ,順發,80080,80080,0,0.00,100.00
1090529,6156  ,松上,81511,81511,0,0.00,100.00
1090529,61562 ,松上二,506,506,0,0.00,33.73
1090529,61563 ,松上三,191,191,0,0.00,19.10
1090529,6158  ,禾昌,52669,52669,0,0.00,100.00
1090529,6160  ,欣技,68489,68489,0,0.00,100.00
1090529,6161  ,捷波,78983,78983,0,0.00,100.00
1090529,6163  ,華電網,103481,103481,0,0.00,100.00
1090529,6167  ,久正,162173,162173,0,0.00,100.00
1090529,6169  ,昱泉,18925,18925,0,0.00,100.00
1090529,6170  ,統振,89670,89670,0,0.00,100.00
1090529,6171  ,亞銳士,75351,75351,0,0.00,100.00
1090529,6173  ,信昌電,172000,172000,0,0.00,100.00
1090529,6174  ,安&#30849;,50000,50000,0,0.00,100.00
1090529,6175  ,立敦,136363,136363,0,0.00,100.00
1090529,61753 ,立敦三,2000,2000,0,0.00,100.00
1090529,61775 ,達麗五,3485,3485,0,0.00,69.70
1090529,61776 ,達麗六,3710,3710,0,0.00,74.20
1090529,6179  ,亞通,74146,74146,0,0.00,100.00
1090529,6180  ,橘子,175493,175493,0,0.00,100.00
1090529,6182  ,合晶,510898,510898,0,0.00,100.00
1090529,6185  ,幃翔,149867,149867,0,0.00,100.00
1090529,6186  ,新潤,100034,100034,0,0.00,100.00
1090529,6187  ,萬潤,83323,83323,0,0.00,100.00
1090529,6188  ,廣明,278358,278358,0,0.00,100.00
1090529,6190  ,萬泰科,140368,140368,0,0.00,100.00
1090529,6194  ,育富,60000,60000,0,0.00,100.00
1090529,6195  ,詩肯,46133,46133,0,0.00,100.00
1090529,61952 ,詩肯二,1524,1524,0,0.00,50.80
1090529,6198  ,凌泰,20135,20135,0,0.00,100.00
1090529,6199  ,天品,61760,61760,0,0.00,100.00
1090529,6203  ,海韻電,79953,79953,0,0.00,100.00
1090529,6204  ,艾華,23102,23102,0,0.00,100.00
1090529,6207  ,雷科,83954,83954,0,0.00,100.00
1090529,6208  ,日揚,103993,103993,0,0.00,100.00
1090529,62083 ,日揚三,4000,0,4000,0.00,100.00
1090529,6210  ,慶生,35048,35048,0,0.00,100.00
1090529,6212  ,理銘,102000,102000,0,0.00,100.00
1090529,6217  ,中探針,65249,65249,0,0.00,100.00
1090529,6218  ,豪勉,64262,64262,0,0.00,100.00
1090529,6219  ,富旺,154016,154016,0,0.00,100.00
1090529,6220  ,岳豐,124554,124554,0,0.00,100.00
1090529,62208 ,岳豐八,7000,7000,0,0.00,100.00
1090529,62209 ,岳豐九,4000,4000,0,0.00,100.00
1090529,6221  ,晉泰,45362,45362,0,0.00,100.00
1090529,6222  ,上揚,10910,10910,0,0.00,100.00
1090529,6223  ,旺矽,79958,79958,0,0.00,100.00
1090529,62234 ,旺矽四,9593,9593,0,0.00,95.93
1090529,6227  ,茂綸,76111,76111,0,0.00,100.00
1090529,6228  ,全譜,21223,21223,0,0.00,100.00
1090529,6229  ,研通,36087,36087,0,0.00,100.00
1090529,6231  ,系微,38043,38043,0,0.00,100.00
1090529,6233  ,旺玖,82368,82368,0,0.00,100.00
1090529,6234  ,高僑,92864,92864,0,0.00,100.00
1090529,6236  ,康呈,5054,5054,0,0.00,100.00
1090529,6237  ,驊訊,79034,79034,0,0.00,100.00
1090529,6238  ,勝麗,57307,57307,0,0.00,100.00
1090529,6240  ,松崗,23098,23098,0,0.00,100.00
1090529,6241  ,易通展,22144,22144,0,0.00,100.00
1090529,6242  ,立康,8015,8015,0,0.00,100.00
1090529,6244  ,茂迪,540451,540451,0,0.00,100.00
1090529,6245  ,立端,118180,118180,0,0.00,100.00
1090529,6246  ,臺龍,14703,14703,0,0.00,100.00
1090529,6247  ,淇譽電,60321,60321,0,0.00,100.00
1090529,6248  ,沛波,14510,14510,0,0.00,100.00
1090529,62482 ,沛波二,1500,1500,0,0.00,100.00
1090529,62483 ,沛波三,1500,1500,0,0.00,100.00
1090529,62573 ,矽格三,12000,12000,0,0.00,100.00
1090529,6259  ,百徽,43279,43279,0,0.00,100.00
1090529,6261  ,久元,128497,128497,0,0.00,100.00
1090529,6263  ,普萊德,62500,62500,0,0.00,100.00
1090529,6264  ,富裔,86224,86224,0,0.00,100.00
1090529,6265  ,&#22531;昶,118172,118172,0,0.00,100.00
1090529,6266  ,泰詠,98946,98946,0,0.00,100.00
1090529,6270  ,倍微,72145,72145,0,0.00,100.00
1090529,6274  ,台燿,265219,265219,0,0.00,100.00
1090529,62743 ,台燿三,18000,18000,0,0.00,100.00
1090529,6275  ,元山,69786,69786,0,0.00,100.00
1090529,6276  ,安鈦克,16633,16633,0,0.00,100.00
1090529,6279  ,胡連,97224,97224,0,0.00,100.00
1090529,6284  ,佳邦,97430,97430,0,0.00,100.00
1090529,6287  ,元隆,75244,75244,0,0.00,100.00
1090529,62875 ,元隆五,2500,2500,0,0.00,100.00
1090529,62881 ,聯嘉一,5000,5000,0,0.00,100.00
1090529,6290  ,良維,143796,143796,0,0.00,100.00
1090529,62907 ,良維七,680,680,0,0.00,34.00
1090529,62908 ,良維八,328,328,0,0.00,10.93
1090529,6291  ,沛亨,5030,5030,0,0.00,100.00
1090529,6292  ,迅德,46900,46900,0,0.00,100.00
1090529,6294  ,智基,23402,23402,0,0.00,100.00
1090529,6404  ,通訊-KY,37368,37368,0,0.00,100.00
1090529,6411  ,晶焱,80158,80158,0,0.00,100.00
1090529,64142 ,樺漢二,122,122,0,0.00,0.67
1090529,64143 ,樺漢三,60000,60000,0,0.00,100.00
1090529,64161 ,瑞祺電通一,7000,7000,0,0.00,100.00
1090529,6417  ,韋僑,35614,35614,0,0.00,100.00
1090529,6418  ,詠昇,34522,34522,0,0.00,100.00
1090529,6419  ,京晨科,10433,10433,0,0.00,100.00
1090529,6425  ,易發,42537,42537,0,0.00,100.00
1090529,6426  ,統新,38509,38509,0,0.00,100.00
1090529,64261 ,統新一,1500,1500,0,0.00,100.00
1090529,6432  ,今展科,24384,24384,0,0.00,100.00
1090529,64322 ,今展科二,1433,1433,0,0.00,71.65
1090529,6435  ,大中,33063,33063,0,0.00,100.00
1090529,6438  ,迅得,60300,60300,0,0.00,100.00
1090529,64381 ,迅得一,4000,4000,0,0.00,100.00
1090529,6441  ,廣錠,30762,30762,0,0.00,100.00
1090529,64411 ,廣錠一,2750,2750,0,0.00,100.00
1090529,64412 ,廣錠二,2250,2250,0,0.00,100.00
1090529,6446  ,藥華藥,219493,219493,0,0.00,100.00
1090529,64492 ,鈺邦二,2500,2500,0,0.00,100.00
1090529,64511 ,訊芯一KY,15000,15000,0,0.00,100.00
1090529,6457  ,紘康,29777,29777,0,0.00,100.00
1090529,6461  ,益得,100244,100244,0,0.00,100.00
1090529,6462  ,神盾,71381,71381,0,0.00,100.00
1090529,6465  ,威潤,32974,32974,0,0.00,100.00
1090529,6469  ,大樹,43604,43604,0,0.00,100.00
1090529,64691 ,大樹一,1624,1624,0,0.00,54.13
1090529,6470  ,宇智,32694,32694,0,0.00,100.00
1090529,6472  ,保瑞,41627,41627,0,0.00,100.00
1090529,64771 ,安集一,3000,3000,0,0.00,100.00
1090529,6482  ,弘煜科,17148,17148,0,0.00,100.00
1090529,6485  ,點序,39383,39383,0,0.00,100.00
1090529,6486  ,互動,36944,36944,0,0.00,100.00
1090529,64861 ,互動一,6000,6000,0,0.00,100.00
1090529,6488  ,環球晶,437250,437250,0,0.00,100.00
1090529,6492  ,生華科,74498,74498,0,0.00,100.00
1090529,6494  ,九齊,31559,31559,0,0.00,100.00
1090529,6496  ,科懋,46667,46667,0,0.00,100.00
1090529,6497  ,亞獅康-KY,189954,189954,0,0.00,100.00
1090529,6499  ,益安,66495,66495,0,0.00,100.00
1090529,6506  ,&#21452;邦,82360,82360,0,0.00,100.00
1090529,6508  ,惠光,84782,84782,0,0.00,100.00
1090529,6509  ,聚和,176133,176133,0,0.00,100.00
1090529,6510  ,精測,32789,32789,0,0.00,100.00
1090529,6512  ,啟發電,25000,25000,0,0.00,100.00
1090529,6514  ,芮特-KY,30015,30015,0,0.00,100.00
1090529,6516  ,勤崴國際,35113,35113,0,0.00,100.00
1090529,6523  ,達爾膚,45047,45047,0,0.00,100.00
1090529,6527  ,明達醫,24276,24276,0,0.00,100.00
1090529,6530  ,創威,33750,33750,0,0.00,100.00
1090529,6532  ,瑞耘,31626,31626,0,0.00,100.00
1090529,65321 ,瑞耘一,2500,2500,0,0.00,100.00
1090529,6535  ,順藥,117699,117699,0,0.00,100.00
1090529,6538  ,倉和,30300,30300,0,0.00,100.00
1090529,6542  ,隆中,31500,31500,0,0.00,100.00
1090529,6547  ,高端疫苗,186716,186716,0,0.00,100.00
1090529,6548  ,長科*,364131,364131,0,0.00,100.00
1090529,6556  ,勝品,23000,23000,0,0.00,100.00
1090529,65581 ,興能高一,5000,5000,0,0.00,100.00
1090529,6560  ,欣普羅,17492,17492,0,0.00,100.00
1090529,6561  ,是方,70224,70224,0,0.00,100.00
1090529,6568  ,宏觀,25100,25100,0,0.00,100.00
1090529,6569  ,醫揚,22008,22008,0,0.00,100.00
1090529,6570  ,維田,27104,27104,0,0.00,100.00
1090529,65731 ,虹揚一KY,5000,5000,0,0.00,100.00
1090529,6574  ,霈方,21990,21990,0,0.00,100.00
1090529,6576  ,逸達,100388,100388,0,0.00,100.00
1090529,6577  ,勁豐,38254,38254,0,0.00,100.00
1090529,6578  ,達邦蛋白,29362,29362,0,0.00,100.00
1090529,6589  ,台康生技,204329,204329,0,0.00,100.00
1090529,65891 ,台康生技一,3000,0,3000,0.00,100.00
1090529,6590  ,普鴻,18291,18291,0,0.00,100.00
1090529,65911 ,動力一KY,674,674,0,0.00,44.93
1090529,6593  ,台灣銘板,20170,20170,0,0.00,100.00
1090529,6594  ,展匯科,20552,20552,0,0.00,100.00
1090529,6596  ,寬宏藝術,27830,27830,0,0.00,100.00
1090529,6603  ,富強鑫,148708,148708,0,0.00,100.00
1090529,66032 ,富強鑫二,1073,1073,0,0.00,35.76
1090529,6609  ,瀧澤科,72456,72456,0,0.00,100.00
1090529,6612  ,奈米醫材,33731,33731,0,0.00,100.00
1090529,6613  ,朋億,33928,33928,0,0.00,100.00
1090529,6615  ,慧智,21219,21219,0,0.00,100.00
1090529,6616  ,特昇-KY,23625,23625,0,0.00,100.00
1090529,66161 ,特昇一KY,2000,2000,0,0.00,100.00
1090529,6624  ,萬年清,18000,18000,0,0.00,100.00
1090529,6629  ,泰金-KY,33530,33530,0,0.00,100.00
1090529,6640  ,均華,28276,28276,0,0.00,100.00
1090529,6642  ,富致,31399,31399,0,0.00,100.00
1090529,6643  ,M31,31318,31318,0,0.00,100.00
1090529,6649  ,台生材,33000,33000,0,0.00,100.00
1090529,6654  ,天正國際,33102,33102,0,0.00,100.00
1090529,6662  ,樂斯科,25612,25612,0,0.00,100.00
1090529,6664  ,群翊,55000,55000,0,0.00,100.00
1090529,6667  ,信紘科,35142,35142,0,0.00,100.00
1090529,66681 ,中揚光一,4000,4000,0,0.00,100.00
1090529,66682 ,中揚光二,2500,2500,0,0.00,100.00
1090529,6679  ,鈺太,41273,41273,0,0.00,100.00
1090529,6680  ,鑫創電子,17500,17500,0,0.00,100.00
1090529,6683  ,雍智科技,27075,27075,0,0.00,100.00
1090529,6690  ,安&#30849;資訊,16339,16339,0,0.00,100.00
1090529,6697  ,東捷資訊,22239,22239,0,0.00,100.00
1090529,67021 ,興航一,1804,1804,0,0.00,18.04
1090529,6803  ,崑鼎,67105,67105,0,0.00,100.00
1090529,702038,中光電台新97購01,10000,10000,0,0.00,100.00
1090529,702039,群聯台新97購01,3000,3000,0,0.00,100.00
1090529,705010,穩懋中信95購02,0,10000,-10000,-100.00,100.00
1090529,705503,保瑞國泰98購01,3100,3100,0,0.00,100.00
1090529,705608,威剛元富95購01,0,1000,-1000,-100.00,100.00
1090529,705684,建榮統一96購01,10000,10000,0,0.00,100.00
1090529,705685,建榮統一96購02,1000,1000,0,0.00,100.00
1090529,705730,群聯元富96購01,2000,2000,0,0.00,100.00
1090529,705741,富喬統一96購01,6000,6000,0,0.00,100.00
1090529,705775,宜鼎群益96購01,500,500,0,0.00,100.00
1090529,705776,原相群益96購01,500,500,0,0.00,100.00
1090529,705788,緯軟元大96購01,1750,1750,0,0.00,100.00
1090529,705803,原相富邦97購01,1000,1000,0,0.00,100.00
1090529,705805,環球晶富邦97購01,10000,10000,0,0.00,100.00
1090529,705847,環球晶統一99購01,1000,1000,0,0.00,100.00
1090529,705848,禾昌元富96購01,5000,5000,0,0.00,100.00
1090529,705869,穩懋元大96購01,6000,6000,0,0.00,100.00
1090529,705904,六角富邦97購01,9000,9000,0,0.00,100.00
1090529,705905,昇達科富邦97購01,10000,10000,0,0.00,100.00
1090529,705924,大江元富96購01,1000,1000,0,0.00,100.00
1090529,706054,穩懋中信95購03,0,5000,-5000,-100.00,100.00
1090529,706056,穩懋元富95購01,0,2000,-2000,-100.00,100.00
1090529,706108,威剛富邦97購01,1500,5000,-3500,-70.00,100.00
1090529,706109,雙鴻富邦97購01,10000,10000,0,0.00,100.00
1090529,706112,原相元大95購01,0,500,-500,-100.00,100.00
1090529,706130,雙美群益95購01,0,800,-800,-100.00,100.00
1090529,706133,鈺太國票95購02,0,500,-500,-100.00,100.00
1090529,706134,穩懋富邦95購01,0,1366,-1366,-100.00,100.00
1090529,706164,博智元大95購01,0,600,-600,-100.00,100.00
1090529,706167,三貝德國票95購01,0,500,-500,-100.00,100.00
1090529,706171,鐿鈦國票95購01,0,500,-500,-100.00,100.00
1090529,706173,神盾國泰95購01,0,500,-500,-100.00,100.00
1090529,706175,譜瑞國泰95購01,0,500,-500,-100.00,100.00
1090529,706194,博智國票95購01,500,500,0,0.00,100.00
1090529,706199,昇達科國泰95購01,500,500,0,0.00,100.00
1090529,706200,保瑞國泰95購02,700,700,0,0.00,100.00
1090529,706256,神盾富邦96購01,1000,1000,0,0.00,100.00
1090529,706267,合晶元大96購01,800,800,0,0.00,100.00
1090529,706296,穩懋統一96購01,1000,1000,0,0.00,100.00
1090529,706302,三貝德國票96購01,500,500,0,0.00,100.00
1090529,706357,網家元富96購01,13500,13500,0,0.00,100.00
1090529,706373,雙鴻國泰96購01,790,790,0,0.00,100.00
1090529,706383,群聯群益96購01,500,500,0,0.00,100.00
1090529,706393,昇達科元大96購01,500,500,0,0.00,100.00
1090529,706410,信昌電元大96購01,600,600,0,0.00,100.00
1090529,706415,緯軟元大96購02,1150,1150,0,0.00,100.00
1090529,706417,雙鴻元大97購01,10000,10000,0,0.00,100.00
1090529,706419,鈺太元大96購01,600,600,0,0.00,100.00
1090529,706423,宏觀群益96購01,5000,5000,0,0.00,100.00
1090529,706427,雙鴻群益96購01,2000,2000,0,0.00,100.00
1090529,706430,建榮國票96購01,500,500,0,0.00,100.00
1090529,706436,穩懋富邦96購01,1176,1176,0,0.00,100.00
1090529,706446,雙鴻麥證96購01,1000,1000,0,0.00,100.00
1090529,706448,威剛元富97購01,1000,1000,0,0.00,100.00
1090529,706461,元太富邦96購01,15000,15000,0,0.00,100.00
1090529,706481,雙鴻群益96購02,1000,1000,0,0.00,100.00
1090529,706513,金居群益96購01,500,1500,-1000,-66.66,100.00
1090529,706516,大田元大96購01,500,500,0,0.00,100.00
1090529,706518,杰力元大96購01,500,500,0,0.00,100.00
1090529,706529,M31國泰96購01,2600,2600,0,0.00,100.00
1090529,706530,群聯國泰96購01,500,500,0,0.00,100.00
1090529,706531,雙鴻國泰96購02,675,675,0,0.00,100.00
1090529,706554,神盾群益96購01,5000,5000,0,0.00,100.00
1090529,706556,由田富邦96購01,545,545,0,0.00,100.00
1090529,706574,建榮元大97購01,1000,1000,0,0.00,100.00
1090529,706596,建榮永豐96購01,500,500,0,0.00,100.00
1090529,706602,大江元大96購01,1800,1800,0,0.00,100.00
1090529,706612,原相群益97購01,500,500,0,0.00,100.00
1090529,706614,櫃200永昌96購01,500,500,0,0.00,100.00
1090529,706615,櫃200永昌96購02,500,500,0,0.00,100.00
1090529,706616,櫃200永昌96購03,501,501,0,0.00,100.00
1090529,706618,原相國泰96購01,500,500,0,0.00,100.00
1090529,706624,雙鴻凱基96購01,647,647,0,0.00,100.00
1090529,706631,櫃200第一96購01,5000,5000,0,0.00,100.00
1090529,706646,昇達科元大96購02,500,500,0,0.00,100.00
1090529,706651,雙美元大96購01,2500,2500,0,0.00,100.00
1090529,706690,環球晶富邦98購01,10000,10000,0,0.00,100.00
1090529,706726,M31元大96購01,1000,1000,0,0.00,100.00
1090529,706731,良維元大97購01,500,500,0,0.00,100.00
1090529,706733,神盾元大96購01,3000,3000,0,0.00,100.00
1090529,706747,安勤統一95購01,0,1000,-1000,-100.00,100.00
1090529,706748,安勤統一95購02,0,1000,-1000,-100.00,100.00
1090529,706751,同致國票95購01,0,500,-500,-100.00,100.00
1090529,706752,波若威國票95購01,0,500,-500,-100.00,100.00
1090529,706754,碩禾台新96購01,1000,1000,0,0.00,100.00
1090529,706758,六角國泰96購01,500,500,0,0.00,100.00
1090529,706759,雙美國泰95購01,0,5700,-5700,-100.00,100.00
1090529,706760,鈺太國泰95購01,0,510,-510,-100.00,100.00
1090529,706761,鐿鈦國泰96購01,500,500,0,0.00,100.00
1090529,706762,大江兆豐95購02,0,5000,-5000,-100.00,100.00
1090529,706763,勝麗兆豐95購01,0,5000,-5000,-100.00,100.00
1090529,706765,六角元大96購01,500,500,0,0.00,100.00
1090529,706767,群聯元大95購04,0,500,-500,-100.00,100.00
1090529,706769,環球晶元大95購02,0,600,-600,-100.00,100.00
1090529,706773,優群群益95購01,0,500,-500,-100.00,100.00
1090529,706774,雙美群益96購01,1254,1254,0,0.00,100.00
1090529,706787,博智國票95購02,0,500,-500,-100.00,100.00
1090529,706788,大學光國泰96購01,510,510,0,0.00,100.00
1090529,706792,威剛元大96購01,539,539,0,0.00,100.00
1090529,706796,鈺太元大96購02,500,1000,-500,-50.00,100.00
1090529,706800,原相元大96購01,500,500,0,0.00,100.00
1090529,706803,環球晶中信97購01,15000,15000,0,0.00,100.00
1090529,706804,由田國泰96購01,500,500,0,0.00,100.00
1090529,706809,神盾元富95購01,0,1000,-1000,-100.00,100.00
1090529,706811,環球晶元富95購03,0,5000,-5000,-100.00,100.00
1090529,706821,雙鴻永豐95購04,0,500,-500,-100.00,100.00
1090529,706822,立端群益95購01,0,600,-600,-100.00,100.00
1090529,706825,穩懋統一96購02,1000,1000,0,0.00,100.00
1090529,706830,迅得元大95購01,0,500,-500,-100.00,100.00
1090529,706833,鈺太元大96購03,500,1000,-500,-50.00,100.00
1090529,706840,良維國票95購01,0,500,-500,-100.00,100.00
1090529,706841,保瑞國票95購01,0,500,-500,-100.00,100.00
1090529,706843,碩禾國票95購01,0,500,-500,-100.00,100.00
1090529,706844,新鉅科富邦98購01,10000,10000,0,0.00,100.00
1090529,706853,神盾元富95購02,0,1000,-1000,-100.00,100.00
1090529,706855,原相兆豐95購02,0,1000,-1000,-100.00,100.00
1090529,706856,環球晶兆豐95購04,0,5000,-5000,-100.00,100.00
1090529,706858,由田群益96購01,600,600,0,0.00,100.00
1090529,706866,凡甲國票95購01,0,618,-618,-100.00,100.00
1090529,706867,中美晶國票95購01,0,500,-500,-100.00,100.00
1090529,706868,神盾國票96購01,500,500,0,0.00,100.00
1090529,706869,環球晶國票95購02,0,500,-500,-100.00,100.00
1090529,706870,原相群益97購02,1500,1500,0,0.00,100.00
1090529,706872,波若威永豐95購01,0,500,-500,-100.00,100.00
1090529,706876,大宇資元大96購01,1000,1000,0,0.00,100.00
1090529,706877,合晶元大95購01,0,700,-700,-100.00,100.00
1090529,706879,信昌電元大95購02,0,500,-500,-100.00,100.00
1090529,706882,緯軟元大96購03,1000,1000,0,0.00,100.00
1090529,706884,環球晶元大95購03,0,1000,-1000,-100.00,100.00
1090529,706889,雙鴻元富96購01,3000,3000,0,0.00,100.00
1090529,706890,信驊凱基95購01,500,500,0,0.00,100.00
1090529,706892,網家凱基95購01,500,500,0,0.00,100.00
1090529,706894,M31元大95購01,1000,1000,0,0.00,100.00
1090529,706898,勝麗元大95購02,1000,1000,0,0.00,100.00
1090529,706899,閎康元大95購01,500,500,0,0.00,100.00
1090529,706902,迅得永豐95購02,519,519,0,0.00,100.00
1090529,706906,大學光國票96購01,500,500,0,0.00,100.00
1090529,706907,合晶國票95購01,500,500,0,0.00,100.00
1090529,706908,皇田國票95購01,500,500,0,0.00,100.00
1090529,706910,閎康國票95購01,500,500,0,0.00,100.00
1090529,706912,鐿鈦國票96購01,800,800,0,0.00,100.00
1090529,706916,M31元大96購02,1000,1000,0,0.00,100.00
1090529,706918,大學光元大96購01,600,600,0,0.00,100.00
1090529,706919,良維元大96購01,500,500,0,0.00,100.00
1090529,706920,宣德元大96購01,500,500,0,0.00,100.00
1090529,706923,聚積元大96購01,1000,1000,0,0.00,100.00
1090529,706928,大學光永豐96購01,526,526,0,0.00,100.00
1090529,706933,神盾中信97購01,20000,20000,0,0.00,100.00
1090529,706934,環宇中信97購01,15000,15000,0,0.00,100.00
1090529,706935,VHQ凱基96購01,500,500,0,0.00,100.00
1090529,706936,台燿凱基96購01,500,500,0,0.00,100.00
1090529,706937,宜鼎凱基96購01,500,500,0,0.00,100.00
1090529,706940,穩懋凱基96購01,500,500,0,0.00,100.00
1090529,706941,譜瑞凱基96購01,500,500,0,0.00,100.00
1090529,706942,大中國票96購01,500,500,0,0.00,100.00
1090529,706945,碩禾國票96購01,500,500,0,0.00,100.00
1090529,706946,環球晶國票96購01,500,500,0,0.00,100.00
1090529,706947,大田國泰96購01,500,500,0,0.00,100.00
1090529,706950,雙鴻富邦96購01,3000,3000,0,0.00,100.00
1090529,706952,新鉅科元富96購01,2000,2000,0,0.00,100.00
1090529,706956,原相群益96購03,718,718,0,0.00,100.00
1090529,706960,雙鴻元大96購01,3250,3250,0,0.00,100.00
1090529,706961,金可中信96購01,10000,10000,0,0.00,100.00
1090529,706962,勝麗中信97購01,10000,10000,0,0.00,100.00
1090529,706963,群聯中信97購01,10000,10000,0,0.00,100.00
1090529,706965,群聯統一96購01,1000,1000,0,0.00,100.00
1090529,706966,三貝德凱基96購01,500,500,0,0.00,100.00
1090529,706969,信驊凱基96購01,500,500,0,0.00,100.00
1090529,706970,茂達凱基96購01,500,500,0,0.00,100.00
1090529,706973,穩懋凱基96購02,500,500,0,0.00,100.00
1090529,706974,穩懋富邦96購03,25000,25000,0,0.00,100.00
1090529,706975,穩懋富邦96購04,10000,10000,0,0.00,100.00
1090529,706976,大江國泰96購01,5000,5000,0,0.00,100.00
1090529,706977,神盾國泰96購01,500,500,0,0.00,100.00
1090529,706984,合晶國票96購01,1000,1000,0,0.00,100.00
1090529,706985,建榮國票96購02,500,500,0,0.00,100.00
1090529,706986,網家國票96購01,500,500,0,0.00,100.00
1090529,706990,中美晶中信97購01,5000,5000,0,0.00,100.00
1090529,706991,弘塑中信97購01,1500,1500,0,0.00,100.00
1090529,706992,神盾中信96購01,3000,3000,0,0.00,100.00
1090529,706993,環球晶中信96購01,10000,10000,0,0.00,100.00
1090529,706995,弘塑統一96購01,500,500,0,0.00,100.00
1090529,706996,群聯統一96購02,1000,1000,0,0.00,100.00
1090529,707000,台燿凱基96購02,500,500,0,0.00,100.00
1090529,707003,神盾凱基96購01,500,500,0,0.00,100.00
1090529,707013,良維兆豐96購01,5000,5000,0,0.00,100.00
1090529,707018,合晶元大96購02,1000,1000,0,0.00,100.00
1090529,707019,金居元大96購01,1500,1500,0,0.00,100.00
1090529,707020,信昌電元大96購02,500,500,0,0.00,100.00
1090529,707024,由田國票96購01,2000,2000,0,0.00,100.00
1090529,707025,杰力國票96購01,800,800,0,0.00,100.00
1090529,707026,晶焱國票96購01,500,500,0,0.00,100.00
1090529,707027,網龍國票96購01,500,500,0,0.00,100.00
1090529,707029,大宇資國泰97購01,530,530,0,0.00,100.00
1090529,707030,建榮國泰97購01,1000,1000,0,0.00,100.00
1090529,707038,譜瑞富邦97購01,2000,2000,0,0.00,100.00
1090529,707046,大宇資元大97購01,1000,1000,0,0.00,100.00
1090529,707048,昇達科元大96購03,500,500,0,0.00,100.00
1090529,707049,杰力元大96購02,500,500,0,0.00,100.00
1090529,707050,信昌電元大96購03,500,500,0,0.00,100.00
1090529,707051,神盾元大97購01,1300,1300,0,0.00,100.00
1090529,707053,群聯元大96購01,500,500,0,0.00,100.00
1090529,707054,合晶國泰97購01,500,500,0,0.00,100.00
1090529,707055,大江國票96購01,500,500,0,0.00,100.00
1090529,707056,台半國票96購01,500,500,0,0.00,100.00
1090529,707061,聯亞國票96購01,500,500,0,0.00,100.00
1090529,707063,中美晶兆豐96購01,5000,5000,0,0.00,100.00
1090529,707065,新普群益97購01,1500,1500,0,0.00,100.00
1090529,707075,廣明永豐96購01,500,500,0,0.00,100.00
1090529,707077,精華中信97購01,5000,5000,0,0.00,100.00
1090529,707078,環宇中信97購02,5000,5000,0,0.00,100.00
1090529,707079,晟德中信97購01,5000,5000,0,0.00,100.00
1090529,707080,弘塑統一98購01,2100,2100,0,0.00,100.00
1090529,707083,大江元大96購02,1000,1000,0,0.00,100.00
1090529,707084,原相元大97購01,600,600,0,0.00,100.00
1090529,707085,群聯元大96購02,674,674,0,0.00,100.00
1090529,707093,廣明國泰96購01,500,500,0,0.00,100.00
1090529,707094,中美晶國票96購01,1500,3500,-2000,-57.14,100.00
1090529,707095,宜鼎國票96購01,500,500,0,0.00,100.00
1090529,707097,穩懋國票96購02,800,800,0,0.00,100.00
1090529,707098,台燿兆豐96購01,5000,5000,0,0.00,100.00
1090529,707099,穩懋兆豐96購01,5000,5000,0,0.00,100.00
1090529,707102,原相群益96購04,500,500,0,0.00,100.00
1090529,707104,六角兆豐96購01,5000,5000,0,0.00,100.00
1090529,707106,原相台新97購01,1000,1000,0,0.00,100.00
1090529,707108,新普群益97購02,1000,1000,0,0.00,100.00
1090529,707109,環宇群益97購01,1100,1100,0,0.00,100.00
1090529,707113,金居元大96購02,500,500,0,0.00,100.00
1090529,707114,建榮元大96購01,500,500,0,0.00,100.00
1090529,707117,聯亞元大96購01,508,508,0,0.00,100.00
1090529,707121,大江國票97購01,543,543,0,0.00,100.00
1090529,707123,保瑞國票96購01,500,500,0,0.00,100.00
1090529,707124,環宇國泰96購01,500,500,0,0.00,100.00
1090529,707125,環球晶國泰96購01,500,500,0,0.00,100.00
1090529,707132,晟德國泰96購01,500,500,0,0.00,100.00
1090529,707133,中光電群益96購01,1500,1500,0,0.00,100.00
1090529,707134,元太群益96購01,1500,1500,0,0.00,100.00
1090529,707135,原相群益97購03,500,500,0,0.00,100.00
1090529,707136,群聯群益97購01,726,726,0,0.00,100.00
1090529,707147,大江元大96購03,1500,1500,0,0.00,100.00
1090529,707149,群聯元大96購03,541,541,0,0.00,100.00
1090529,707154,雙鴻元大97購02,1750,1750,0,0.00,100.00
1090529,707157,同致兆豐96購01,5000,5000,0,0.00,100.00
1090529,707158,威剛兆豐96購01,5000,5000,0,0.00,100.00
1090529,707159,網龍兆豐96購01,1000,1000,0,0.00,100.00
1090529,707161,元太國票96購01,800,800,0,0.00,100.00
1090529,707162,旺矽國票96購01,500,500,0,0.00,100.00
1090529,707163,信昌電國票96購01,1500,2000,-500,-25.00,100.00
1090529,707164,宣德國票96購01,1000,2000,-1000,-50.00,100.00
1090529,707165,聚積國票96購01,1000,1000,0,0.00,100.00
1090529,707166,譜瑞國票96購01,500,500,0,0.00,100.00
1090529,707167,中美晶國泰96購01,500,500,0,0.00,100.00
1090529,707168,群聯國泰97購01,950,950,0,0.00,100.00
1090529,707169,群聯富邦96購01,978,978,0,0.00,100.00
1090529,707170,環宇富邦97購01,8000,8000,0,0.00,100.00
1090529,707171,弘塑中信99購01,5000,5000,0,0.00,100.00
1090529,707172,環球晶中信99購01,15000,15000,0,0.00,100.00
1090529,707173,鈺太中信96購01,1000,1000,0,0.00,100.00
1090529,707174,凡甲凱基96購01,500,500,0,0.00,100.00
1090529,707175,大江凱基96購01,500,500,0,0.00,100.00
1090529,707178,威剛凱基97購01,512,512,0,0.00,100.00
1090529,707189,美琪瑪元大96購01,500,500,0,0.00,100.00
1090529,707190,神盾元大96購02,1250,1250,0,0.00,100.00
1090529,707196,閎康群益96購01,1600,1600,0,0.00,100.00
1090529,707197,順達群益96購01,1500,1500,0,0.00,100.00
1090529,707198,VHQ國票96購01,500,500,0,0.00,100.00
1090529,707200,網龍國票97購01,800,800,0,0.00,100.00
1090529,707201,環球晶國票96購02,500,500,0,0.00,100.00
1090529,707202,聯亞國票96購02,700,700,0,0.00,100.00
1090529,707207,宇峻元大97購01,503,503,0,0.00,100.00
1090529,707213,順達統一97購01,2100,2100,0,0.00,100.00
1090529,707233,迅得群益97購01,2000,2000,0,0.00,100.00
1090529,707235,群聯群益96購02,500,500,0,0.00,100.00
1090529,707236,聚積群益97購01,700,1200,-500,-41.66,100.00
1090529,707241,昇達科國票96購01,620,620,0,0.00,100.00
1090529,707242,信驊國票96購01,500,500,0,0.00,100.00
1090529,707243,新普國票96購01,500,500,0,0.00,100.00
1090529,707244,精華國票96購01,800,800,0,0.00,100.00
1090529,707246,弘塑元大96購01,550,750,-200,-26.66,100.00
1090529,707248,建榮元大96購02,500,500,0,0.00,100.00
1090529,707252,鐿鈦元大96購01,500,500,0,0.00,100.00
1090529,707253,穩懋亞東96購02,1400,1400,0,0.00,100.00
1090529,707254,同致中信97購01,5000,5000,0,0.00,100.00
1090529,707262,大宇資凱基97購01,500,500,0,0.00,100.00
1090529,707263,神盾凱基96購02,500,500,0,0.00,100.00
1090529,707275,元太元大96購01,1500,1500,0,0.00,100.00
1090529,707277,神盾元大97購02,6250,6250,0,0.00,100.00
1090529,707278,勝麗元大96購01,500,500,0,0.00,100.00
1090529,707280,碩禾元大96購01,800,800,0,0.00,100.00
1090529,707285,弘塑國泰97購01,1000,1000,0,0.00,100.00
1090529,707287,同致國票96購01,500,500,0,0.00,100.00
1090529,707288,良維國票97購01,800,800,0,0.00,100.00
1090529,707289,緯軟國票97購01,800,800,0,0.00,100.00
1090529,707290,優群國票96購01,500,500,0,0.00,100.00
1090529,707293,泰博兆豐96購01,1000,1000,0,0.00,100.00
1090529,707294,VHQ群益96購01,880,880,0,0.00,100.00
1090529,707297,台燿凱基96購03,500,500,0,0.00,100.00
1090529,707302,原相亞東96購01,550,550,0,0.00,100.00
1090529,707309,合晶國票96購02,1500,1500,0,0.00,100.00
1090529,707310,原相國票96購01,500,500,0,0.00,100.00
1090529,707315,大江元大96購04,4500,4500,0,0.00,100.00
1090529,707316,同致元大96購01,800,800,0,0.00,100.00
1090529,707323,環宇元大96購01,1100,1100,0,0.00,100.00
1090529,707324,櫃200永昌96購04,500,500,0,0.00,100.00
1090529,707325,M31中信96購01,5000,5000,0,0.00,100.00
1090529,707326,穩懋中信97購01,4500,4500,0,0.00,100.00
1090529,707328,中美晶凱基96購01,500,500,0,0.00,100.00
1090529,707333,大江國票96購04,500,500,0,0.00,100.00
1090529,707334,合晶國票97購01,500,500,0,0.00,100.00
1090529,707335,勝麗國票97購01,800,800,0,0.00,100.00
1090529,707336,群聯國票96購01,500,500,0,0.00,100.00
1090529,707337,網龍國票97購02,800,800,0,0.00,100.00
1090529,707338,環球晶國票96購03,500,500,0,0.00,100.00
1090529,707339,晟德國票97購01,500,500,0,0.00,100.00
1090529,707340,神盾國泰97購01,500,500,0,0.00,100.00
1090529,707341,博智國泰97購01,500,500,0,0.00,100.00
1090529,707342,原相富邦99購01,2500,2500,0,0.00,100.00
1090529,707343,聯亞兆豐96購01,1000,1000,0,0.00,100.00
1090529,707345,宣德群益96購01,543,543,0,0.00,100.00
1090529,707346,皇田群益97購01,1000,1000,0,0.00,100.00
1090529,707347,金居元大96購03,500,700,-200,-28.57,100.00
1090529,707348,保瑞元大96購01,500,500,0,0.00,100.00
1090529,707349,茂達元大96購01,500,500,0,0.00,100.00
1090529,707350,優群元大96購01,500,500,0,0.00,100.00
1090529,707351,環球晶元大96購01,600,600,0,0.00,100.00
1090529,707352,櫃200元大96購03,1000,1000,0,0.00,100.00
1090529,707353,櫃200元大96購04,1000,1000,0,0.00,100.00
1090529,707354,昇達科中信97購01,5000,5000,0,0.00,100.00
1090529,707357,大江國票97購02,800,800,0,0.00,100.00
1090529,707361,元太元大96購02,10000,10000,0,0.00,100.00
1090529,707363,合晶元大96購03,600,600,0,0.00,100.00
1090529,707365,群聯元大97購01,947,947,0,0.00,100.00
1090529,707366,廣明元大96購01,829,829,0,0.00,100.00
1090529,707368,茂達永豐96購01,500,500,0,0.00,100.00
1090529,707370,杰力國票96購02,800,800,0,0.00,100.00
1090529,707371,大江富邦97購01,5000,5000,0,0.00,100.00
1090529,707372,原相凱基96購01,962,962,0,0.00,100.00
1090529,707376,雙鴻凱基96購03,673,673,0,0.00,100.00
1090529,707385,晶焱元大96購01,1000,1000,0,0.00,100.00
1090529,707395,大宇資群益97購01,5000,5000,0,0.00,100.00
1090529,707400,威剛元大96購02,500,500,0,0.00,100.00
1090529,707402,大宇資永豐96購01,1000,1000,0,0.00,100.00
1090529,707403,旺矽永豐96購01,500,500,0,0.00,100.00
1090529,707405,優群永豐96購01,500,500,0,0.00,100.00
1090529,707406,M31國票96購01,500,500,0,0.00,100.00
1090529,707407,中美晶國票96購03,500,500,0,0.00,100.00
1090529,707408,兆利國票96購01,500,500,0,0.00,100.00
1090529,707410,雙美國票96購01,500,1111,-611,-54.99,100.00
1090529,707415,櫃200T永昌96購01,500,500,0,0.00,100.00
1090529,707416,櫃200T永昌96購02,500,500,0,0.00,100.00
1090529,707417,櫃200T永昌96購03,500,500,0,0.00,100.00
1090529,707418,櫃200T永昌96購04,500,500,0,0.00,100.00
1090529,707421,緯軟凱基96購01,500,500,0,0.00,100.00
1090529,707422,櫃200凱基99購01,5000,5000,0,0.00,100.00
1090529,707423,三貝德國票96購02,552,552,0,0.00,100.00
1090529,707424,大學光國票96購02,500,500,0,0.00,100.00
1090529,707425,台燿國票96購01,800,800,0,0.00,100.00
1090529,707426,穩懋國票96購03,800,800,0,0.00,100.00
1090529,707427,新普國泰96購01,500,500,0,0.00,100.00
1090529,707428,譜瑞國泰97購01,500,500,0,0.00,100.00
1090529,707432,雙鴻台新96購01,1000,1000,0,0.00,100.00
1090529,707434,環球晶元大96購02,6000,6000,0,0.00,100.00
1090529,707437,群聯兆豐96購01,1500,1500,0,0.00,100.00
1090529,707440,昇達科群益97購01,2300,2300,0,0.00,100.00
1090529,707441,晶焱群益96購01,1500,1500,0,0.00,100.00
1090529,707442,櫃200富邦9A購01,1019,1019,0,0.00,100.00
1090529,707443,櫃200富邦9A購02,1014,1014,0,0.00,100.00
1090529,707444,雙鴻富邦96購02,3000,3000,0,0.00,100.00
1090529,707450,大江中信96購01,1000,1000,0,0.00,100.00
1090529,707451,大江台新95購01,0,1000,-1000,-100.00,100.00
1090529,707452,兆利元大96購01,1200,1200,0,0.00,100.00
1090529,707453,迅得元大95購02,0,500,-500,-100.00,100.00
1090529,707454,博智元大95購03,0,500,-500,-100.00,100.00
1090529,707455,神盾康和95購01,0,500,-500,-100.00,100.00
1090529,707456,勝麗群益95購02,0,1100,-1100,-100.00,100.00
1090529,707457,緯軟群益96購01,1500,1500,0,0.00,100.00
1090529,707458,金居統一95購01,0,1000,-1000,-100.00,100.00
1090529,707459,迅得凱基98購01,500,500,0,0.00,100.00
1090529,707460,邦特凱基95購01,0,500,-500,-100.00,100.00
1090529,707461,信昌電凱基97購01,500,500,0,0.00,100.00
1090529,707462,茂達凱基9B購01,500,500,0,0.00,100.00
1090529,707463,神盾凱基9B購01,500,500,0,0.00,100.00
1090529,707464,勝麗凱基97購01,500,500,0,0.00,100.00
1090529,707465,閎康凱基97購01,545,545,0,0.00,100.00
1090529,707466,環宇凱基97購01,500,500,0,0.00,100.00
1090529,707467,環球晶凱基96購01,500,500,0,0.00,100.00
1090529,707468,穩懋凱基96購03,500,500,0,0.00,100.00
1090529,707469,鈺太凱基97購01,500,500,0,0.00,100.00
1090529,707470,鐿鈦凱基96購01,500,500,0,0.00,100.00
1090529,707471,信昌電國票96購02,1500,1500,0,0.00,100.00
1090529,707472,晶焱國票96購02,1000,1000,0,0.00,100.00
1090529,707473,群聯國票96購02,500,500,0,0.00,100.00
1090529,707474,穩懋富邦97購01,10000,10000,0,0.00,100.00
1090529,707475,光洋科永豐95購01,0,1500,-1500,-100.00,100.00
1090529,707476,穩懋永豐95購03,0,500,-500,-100.00,100.00
1090529,707477,網龍中信95購01,0,5000,-5000,-100.00,100.00
1090529,707478,中美晶凱基95購03,0,500,-500,-100.00,100.00
1090529,707479,晶焱凱基96購01,500,500,0,0.00,100.00
1090529,707480,環球晶凱基97購01,500,500,0,0.00,100.00
1090529,707481,三貝德永豐95購01,0,500,-500,-100.00,100.00
1090529,707482,神盾永豐95購02,0,500,-500,-100.00,100.00
1090529,707483,環球晶永豐95購04,0,500,-500,-100.00,100.00
1090529,707484,大江元大96購05,1000,1000,0,0.00,100.00
1090529,707485,同致元大97購01,500,500,0,0.00,100.00
1090529,707487,迅得國票96購01,600,600,0,0.00,100.00
1090529,707488,宜鼎國票96購02,500,500,0,0.00,100.00
1090529,707489,美琪瑪國票96購01,800,800,0,0.00,100.00
1090529,707490,智崴國泰96購01,1890,1890,0,0.00,100.00
1090529,707491,櫃200T永昌9C購01,880,880,0,0.00,100.00
1090529,707492,櫃200T永昌9C購02,500,500,0,0.00,100.00
1090529,707493,櫃200T永昌9C購03,500,500,0,0.00,100.00
1090529,707494,櫃200T永昌9C購04,500,500,0,0.00,100.00
1090529,707495,穩懋康和95購02,0,5000,-5000,-100.00,100.00
1090529,707496,精華群益95購03,0,900,-900,-100.00,100.00
1090529,707497,宜鼎元大95購02,0,700,-700,-100.00,100.00
1090529,707498,旺矽元大96購01,500,1000,-500,-50.00,100.00
1090529,707499,精華元大95購03,0,10000,-10000,-100.00,100.00
1090529,707500,智崴國票96購01,500,500,0,0.00,100.00
1090529,707501,閎康國票97購01,800,800,0,0.00,100.00
1090529,707502,金可國泰97購01,500,500,0,0.00,100.00
1090529,707503,精華國泰97購01,500,500,0,0.00,100.00
1090529,707504,環球晶國泰96購03,500,500,0,0.00,100.00
1090529,707505,穩懋國泰96購02,600,600,0,0.00,100.00
1090529,707506,穩懋統一96購05,5000,5000,0,0.00,100.00
1090529,707507,三貝德凱基96購02,500,500,0,0.00,100.00
1090529,707508,中美晶凱基95購04,0,500,-500,-100.00,100.00
1090529,707509,元太凱基96購01,516,516,0,0.00,100.00
1090529,707511,建榮凱基97購01,500,500,0,0.00,100.00
1090529,707512,穩懋凱基96購04,1411,1411,0,0.00,100.00
1090529,707513,元太第一95購01,0,15000,-15000,-100.00,100.00
1090529,707514,晶焱永豐95購02,0,500,-500,-100.00,100.00
1090529,707515,精華永豐95購02,0,500,-500,-100.00,100.00
1090529,707516,聚積永豐95購01,0,590,-590,-100.00,100.00
1090529,707517,穩懋兆豐96購02,5000,5000,0,0.00,100.00
1090529,707518,金可康和95購01,0,5000,-5000,-100.00,100.00
1090529,707519,金可群益95購01,0,700,-700,-100.00,100.00
1090529,707520,優群群益97購01,500,500,0,0.00,100.00
1090529,707521,環球晶群益95購04,0,550,-550,-100.00,100.00
1090529,707522,聯亞群益95購02,0,600,-600,-100.00,100.00
1090529,707523,群聯元富95購02,0,2000,-2000,-100.00,100.00
1090529,707524,鈺太兆豐95購01,0,1000,-1000,-100.00,100.00
1090529,707525,泰博中信97購01,1000,4500,-3500,-77.77,100.00
1090529,707526,建榮凱基96購01,500,500,0,0.00,100.00
1090529,707527,新普凱基95購02,0,500,-500,-100.00,100.00
1090529,707528,精華凱基96購01,500,500,0,0.00,100.00
1090529,707529,精華統一97購01,5000,5000,0,0.00,100.00
1090529,707530,精華統一97購02,5000,5000,0,0.00,100.00
1090529,707531,神盾國票97購01,1500,1500,0,0.00,100.00
1090529,707532,群聯國票96購03,500,500,0,0.00,100.00
1090529,707533,緯軟國票97購02,800,800,0,0.00,100.00
1090529,707534,碩禾元大98購01,1500,1500,0,0.00,100.00
1090529,707535,精華元大96購01,10000,10000,0,0.00,100.00
1090529,707536,穩懋元大95購12,0,1000,-1000,-100.00,100.00
1090529,707537,穩懋元大95購13,0,1500,-1500,-100.00,100.00
1090529,707538,世界永豐95購01,0,500,-500,-100.00,100.00
1090529,707539,合晶永豐95購03,0,700,-700,-100.00,100.00
1090529,707540,宇峻永豐95購02,0,600,-600,-100.00,100.00
1090529,707541,佳邦永豐95購01,0,500,-500,-100.00,100.00
1090529,707542,金居永豐95購01,0,500,-500,-100.00,100.00
1090529,707543,泰博永豐95購01,0,500,-500,-100.00,100.00
1090529,707544,勝麗永豐95購02,0,500,-500,-100.00,100.00
1090529,707545,晟德永豐95購02,0,500,-500,-100.00,100.00
1090529,707546,台半亞東96購01,1500,1500,0,0.00,100.00
1090529,707547,世界中信96購01,5000,5000,0,0.00,100.00
1090529,707548,精測中信95購01,0,5000,-5000,-100.00,100.00
1090529,707549,精測凱基96購01,500,500,0,0.00,100.00
1090529,707550,聯亞凱基95購03,0,500,-500,-100.00,100.00
1090529,707551,穩懋凱基95購03,0,500,-500,-100.00,100.00
1090529,707552,精測統一96購01,1000,1000,0,0.00,100.00
1090529,707553,安勤永豐95購01,0,500,-500,-100.00,100.00
1090529,707554,金可永豐95購02,0,500,-500,-100.00,100.00
1090529,707555,宣德永豐95購03,0,500,-500,-100.00,100.00
1090529,707556,精測永豐96購01,500,500,0,0.00,100.00
1090529,707557,廣明永豐95購02,0,500,-500,-100.00,100.00
1090529,707558,台燿亞東95購01,0,2000,-2000,-100.00,100.00
1090529,707559,信昌電亞東95購01,0,500,-500,-100.00,100.00
1090529,707560,精測元富95購01,0,3000,-3000,-100.00,100.00
1090529,707561,M31國票96購02,500,500,0,0.00,100.00
1090529,707562,由田國票97購01,1000,1000,0,0.00,100.00
1090529,707563,宇峻國票96購01,500,500,0,0.00,100.00
1090529,707564,環球晶國票96購04,500,500,0,0.00,100.00
1090529,707565,精測國泰95購01,0,1100,-1100,-100.00,100.00
1090529,707566,大江元大96購06,1000,1000,0,0.00,100.00
1090529,707567,合晶元大96購04,500,1000,-500,-50.00,100.00
1090529,707568,勝麗元大95購03,0,5000,-5000,-100.00,100.00
1090529,707569,群聯元大95購07,0,5000,-5000,-100.00,100.00
1090529,707570,精測元大95購02,0,800,-800,-100.00,100.00
1090529,707571,優群元大97購01,600,600,0,0.00,100.00
1090529,707572,穩懋元大95購14,0,10000,-10000,-100.00,100.00
1090529,707573,穩懋元大96購02,10000,10000,0,0.00,100.00
1090529,707574,大江富邦97購03,10000,10000,0,0.00,100.00
1090529,707575,雙鴻康和95購02,0,1500,-1500,-100.00,100.00
1090529,707576,元太群益95購02,0,1000,-1000,-100.00,100.00
1090529,707577,神盾群益97購01,2300,2300,0,0.00,100.00
1090529,707578,精測群益95購01,0,840,-840,-100.00,100.00
1090529,707579,聯亞群益95購03,0,500,-500,-100.00,100.00
1090529,707580,雙鴻群益96購03,1168,1168,0,0.00,100.00
1090529,707581,世界元大96購01,5000,5000,0,0.00,100.00
1090529,707582,金可元大96購01,1500,1500,0,0.00,100.00
1090529,707583,順達元大96購01,1500,1500,0,0.00,100.00
1090529,707584,精測元大97購01,1000,1000,0,0.00,100.00
1090529,707585,精華元大96購02,500,500,0,0.00,100.00
1090529,707586,新鉅科元富96購02,2000,2000,0,0.00,100.00
1090529,707587,精測元富96購01,1000,1000,0,0.00,100.00
1090529,707588,廣明元富96購01,6000,6000,0,0.00,100.00
1090529,707589,宣德統一96購01,5000,5000,0,0.00,100.00
1090529,707590,群聯統一96購03,1000,1000,0,0.00,100.00
1090529,707591,精測統一97購01,1000,1000,0,0.00,100.00
1090529,707592,穩懋統一97購01,5000,5000,0,0.00,100.00
1090529,707593,穩懋統一98購01,5000,5000,0,0.00,100.00
1090529,707595,精測凱基97購01,500,500,0,0.00,100.00
1090529,707596,精測凱基97購02,500,500,0,0.00,100.00
1090529,707597,雙鴻凱基96購04,664,664,0,0.00,100.00
1090529,707598,穩懋凱基96購05,500,500,0,0.00,100.00
1090529,707599,大江永豐96購01,500,500,0,0.00,100.00
1090529,707600,中美晶永豐96購01,500,500,0,0.00,100.00
1090529,707601,精測永豐96購02,500,500,0,0.00,100.00
1090529,707602,精測永豐97購01,1000,1000,0,0.00,100.00
1090529,707603,邦特國票97購01,500,500,0,0.00,100.00
1090529,707604,金可國票97購01,1139,1139,0,0.00,100.00
1090529,707605,群聯富邦97購01,1574,1574,0,0.00,100.00
1090529,707606,精測富邦96購01,3000,3000,0,0.00,100.00
1090529,707607,精測兆豐97購01,1000,1000,0,0.00,100.00
1090529,707608,東洋群益96購01,900,900,0,0.00,100.00
1090529,707609,金居群益98購01,1500,1500,0,0.00,100.00
1090529,707610,保瑞群益98購01,2000,2000,0,0.00,100.00
1090529,707611,新鉅科群益96購01,700,700,0,0.00,100.00
1090529,707612,精測群益96購01,1000,1000,0,0.00,100.00
1090529,707613,鈊象台新97購01,1000,1000,0,0.00,100.00
1090529,707614,精測中信96購02,2000,2000,0,0.00,100.00
1090529,707615,鈊象中信96購01,1000,1000,0,0.00,100.00
1090529,707616,M31凱基97購01,500,500,0,0.00,100.00
1090529,707617,宣德凱基96購01,500,500,0,0.00,100.00
1090529,707618,精測凱基97購03,500,500,0,0.00,100.00
1090529,707619,璟德凱基96購01,500,500,0,0.00,100.00
1090529,707620,鐿鈦凱基96購02,500,500,0,0.00,100.00
1090529,707621,精測統一97購02,1000,1000,0,0.00,100.00
1090529,707622,鈊象統一96購01,1000,1000,0,0.00,100.00
1090529,707623,勝麗兆豐96購01,5000,5000,0,0.00,100.00
1090529,707624,精測康和96購02,1000,1000,0,0.00,100.00
1090529,707625,鈊象康和96購01,1000,1000,0,0.00,100.00
1090529,707626,環球晶永昌99購01,702,702,0,0.00,100.00
1090529,707627,迅得永豐97購01,500,500,0,0.00,100.00
1090529,707628,旺矽永豐97購01,1020,1020,0,0.00,100.00
1090529,707629,昇達科永豐97購01,1000,1000,0,0.00,100.00
1090529,707630,僑威永豐96購01,500,500,0,0.00,100.00
1090529,707631,璟德永豐96購01,500,500,0,0.00,100.00
1090529,707632,鈊象永豐96購01,500,500,0,0.00,100.00
1090529,707633,鈊象永豐97購01,500,500,0,0.00,100.00
1090529,707634,元太元大96購03,10000,10000,0,0.00,100.00
1090529,707635,宣德元大96購02,500,500,0,0.00,100.00
1090529,707636,新普元大96購01,1000,1000,0,0.00,100.00
1090529,707637,群聯元大97購02,500,500,0,0.00,100.00
1090529,707638,精測元大96購01,1000,1000,0,0.00,100.00
1090529,707639,鈊象元大97購01,500,500,0,0.00,100.00
1090529,707640,波若威國票97購01,693,693,0,0.00,100.00
1090529,707641,聯亞國票97購01,500,500,0,0.00,100.00
1090529,707642,宣德國泰97購01,850,850,0,0.00,100.00
1090529,707643,原相國泰98購01,2500,2500,0,0.00,100.00
1090529,707644,精測國泰98購01,800,800,0,0.00,100.00
1090529,707645,鈊象國泰98購01,500,500,0,0.00,100.00
1090529,707646,鈊象群益99購01,1500,1500,0,0.00,100.00
1090529,707647,鈺太中信96購02,1500,1500,0,0.00,100.00
1090529,707648,雙鴻統一96購01,1500,1500,0,0.00,100.00
1090529,707649,鈊象統一96購02,1000,1000,0,0.00,100.00
1090529,707650,宇峻凱基98購01,1580,1580,0,0.00,100.00
1090529,707651,精測凱基96購03,811,811,0,0.00,100.00
1090529,707652,環球晶凱基96購03,500,500,0,0.00,100.00
1090529,707653,櫃200凱基96購03,5000,5000,0,0.00,100.00
1090529,707654,雙美凱基97購01,500,500,0,0.00,100.00
1090529,707655,穩懋凱基96購06,500,500,0,0.00,100.00
1090529,707656,鈊象凱基96購01,611,611,0,0.00,100.00
1090529,707657,鈊象凱基97購01,500,500,0,0.00,100.00
1090529,707658,信昌電元富96購01,2000,2000,0,0.00,100.00
1090529,707659,精測元富96購02,5000,5000,0,0.00,100.00
1090529,707660,鈊象元富96購01,1000,1000,0,0.00,100.00
1090529,707661,宣德台新96購01,5000,5000,0,0.00,100.00
1090529,707662,凡甲國票97購01,500,500,0,0.00,100.00
1090529,707663,世界國票97購01,1000,1000,0,0.00,100.00
1090529,707664,杰力國票97購01,1000,1000,0,0.00,100.00
1090529,707665,原相國票98購01,500,500,0,0.00,100.00
1090529,707666,鈊象國票96購02,500,500,0,0.00,100.00
1090529,707667,精測國泰98購02,800,800,0,0.00,100.00
1090529,707668,合晶富邦96購01,9000,9000,0,0.00,100.00
1090529,707669,安勤永豐97購01,500,500,0,0.00,100.00
1090529,707670,閎康永豐96購01,500,500,0,0.00,100.00
1090529,707671,精測永豐96購04,500,500,0,0.00,100.00
1090529,707672,晶焱兆豐97購01,5000,5000,0,0.00,100.00
1090529,707673,雙鴻兆豐97購02,5000,5000,0,0.00,100.00
1090529,707674,合晶元大97購01,1000,1000,0,0.00,100.00
1090529,707675,茂達元大97購01,500,500,0,0.00,100.00
1090529,707676,原相元大97購02,600,600,0,0.00,100.00
1090529,707677,勝麗元大96購02,600,600,0,0.00,100.00
1090529,707678,精測元大98購01,1000,1000,0,0.00,100.00
1090529,707679,璟德元大96購01,1000,1000,0,0.00,100.00
1090529,707680,鈊象元大98購01,500,500,0,0.00,100.00
1090529,707681,力麒康和96購01,5000,5000,0,0.00,100.00
1090529,707682,精測康和96購03,15000,15000,0,0.00,100.00
1090529,707683,東隆興群益96購01,800,800,0,0.00,100.00
1090529,707684,金居群益98購02,1500,1500,0,0.00,100.00
1090529,707685,保瑞群益98購02,1500,1500,0,0.00,100.00
1090529,707686,神盾群益98購01,5000,5000,0,0.00,100.00
1090529,707687,順達群益96購02,1500,1500,0,0.00,100.00
1090529,707688,緯軟統一96購01,5000,5000,0,0.00,100.00
1090529,707689,穩懋統一96購06,5000,5000,0,0.00,100.00
1090529,707690,鈊象統一96購03,1000,1000,0,0.00,100.00
1090529,707691,同致元大97購02,500,500,0,0.00,100.00
1090529,707692,迅得元大97購01,7000,7000,0,0.00,100.00
1090529,707693,晶焱元大97購01,1000,1000,0,0.00,100.00
1090529,707694,群聯元大97購03,531,531,0,0.00,100.00
1090529,707695,優群元大97購02,600,1000,-400,-40.00,100.00
1090529,707696,聯亞元大97購01,500,500,0,0.00,100.00
1090529,707697,穩懋元大96購03,1500,1500,0,0.00,100.00
1090529,707698,鈊象元大97購02,500,500,0,0.00,100.00
1090529,707699,原相元富96購01,500,500,0,0.00,100.00
1090529,707700,精華元富96購01,2000,2000,0,0.00,100.00
1090529,707701,環球晶元富96購01,5000,5000,0,0.00,100.00
1090529,707702,鈊象台新98購01,5000,5000,0,0.00,100.00
1090529,707703,M31凱基96購01,500,500,0,0.00,100.00
1090529,707704,金可凱基97購01,500,500,0,0.00,100.00
1090529,707705,金居凱基96購01,500,500,0,0.00,100.00
1090529,707706,精華凱基96購02,500,500,0,0.00,100.00
1090529,707707,環球晶凱基96購04,500,500,0,0.00,100.00
1090529,707708,聯亞凱基96購01,500,500,0,0.00,100.00
1090529,707709,鐿鈦凱基97購01,500,500,0,0.00,100.00
1090529,707710,大田國票97購01,500,500,0,0.00,100.00
1090529,707711,六角國票98購01,500,500,0,0.00,100.00
1090529,707713,晶焱國票97購01,1000,1000,0,0.00,100.00
1090529,707714,群聯國票97購01,500,500,0,0.00,100.00
1090529,707715,大江國泰98購01,500,500,0,0.00,100.00
1090529,707716,晶焱國泰98購01,1000,1000,0,0.00,100.00
1090529,707717,穩懋國泰97購01,800,800,0,0.00,100.00
1090529,707718,良維永豐96購01,500,500,0,0.00,100.00
1090529,707719,威剛永豐96購01,500,500,0,0.00,100.00
1090529,707720,宣德永豐97購01,500,500,0,0.00,100.00
1090529,707721,鈊象永豐96購03,500,500,0,0.00,100.00
1090529,707722,三貝德群益96購01,600,600,0,0.00,100.00
1090529,707723,宜鼎群益96購02,700,700,0,0.00,100.00
1090529,707724,長科*群益96購01,2600,2600,0,0.00,100.00
1090529,707725,閎康群益97購01,1250,1250,0,0.00,100.00
1090529,707726,晟德群益96購01,1400,1400,0,0.00,100.00
1090529,707727,鈊象群益99購02,5000,5000,0,0.00,100.00
1090529,707728,鈊象康和96購03,1000,1000,0,0.00,100.00
1090529,707729,鈊象凱基98購01,500,500,0,0.00,100.00
1090529,707730,穩懋元富96購01,2500,2500,0,0.00,100.00
1090529,707731,環球晶亞東97購01,2000,2000,0,0.00,100.00
1090529,707732,凡甲永豐97購01,1027,1027,0,0.00,100.00
1090529,707733,大宇資永豐96購02,500,500,0,0.00,100.00
1090529,707734,元太國票97購01,700,1000,-300,-30.00,100.00
1090529,707735,台燿國票97購01,500,500,0,0.00,100.00
1090529,707736,信驊國票97購01,500,500,0,0.00,100.00
1090529,707737,新普國票97購01,500,500,0,0.00,100.00
1090529,707738,聖暉國泰96購01,600,600,0,0.00,100.00
1090529,707739,網家國泰97購01,1197,1197,0,0.00,100.00
1090529,707740,金可兆豐96購01,5000,5000,0,0.00,100.00
1090529,707741,胡連康和96購01,5000,5000,0,0.00,100.00
1090529,707742,佳邦群益96購01,800,800,0,0.00,100.00
1090529,707743,旺矽群益97購01,700,700,0,0.00,100.00
1090529,707744,新普群益98購01,1000,1000,0,0.00,100.00
1090529,707745,網龍群益98購01,2500,2500,0,0.00,100.00
1090529,707746,由田元大96購01,500,500,0,0.00,100.00
1090529,707747,信昌電元大97購01,1000,1000,0,0.00,100.00
1090529,707748,神盾元大99購01,2000,2000,0,0.00,100.00
1090529,707749,精華元大97購01,500,500,0,0.00,100.00
1090529,707750,穩懋元大97購01,1019,1019,0,0.00,100.00
1090529,707751,鈺太元大97購01,8000,8000,0,0.00,100.00
1090529,707752,世界中信98購01,5000,5000,0,0.00,100.00
1090529,707753,環球晶中信99購02,25000,25000,0,0.00,100.00
1090529,707754,環球晶統一96購01,5000,5000,0,0.00,100.00
1090529,707755,穩懋統一96購07,5000,5000,0,0.00,100.00
1090529,707756,世界凱基96購01,500,500,0,0.00,100.00
1090529,707757,網龍凱基97購01,500,500,0,0.00,100.00
1090529,707758,穩懋凱基96購07,500,500,0,0.00,100.00
1090529,707759,大江元大97購01,1000,1000,0,0.00,100.00
1090529,707760,世界元大96購02,8000,8000,0,0.00,100.00
1090529,707761,迅得元大98購01,1000,1000,0,0.00,100.00
1090529,707762,宣德元大96購03,500,500,0,0.00,100.00
1090529,707763,群聯元大96購04,500,500,0,0.00,100.00
1090529,707764,鈊象元大96購03,1000,1000,0,0.00,100.00
1090529,707765,原相永昌99購01,790,790,0,0.00,100.00
1090529,707766,大田永豐96購01,500,500,0,0.00,100.00
1090529,707767,中美晶永豐96購02,500,500,0,0.00,100.00
1090529,707768,世界永豐96購02,500,500,0,0.00,100.00
1090529,707769,光頡永豐96購01,500,500,0,0.00,100.00
1090529,707770,合晶永豐97購01,1000,1000,0,0.00,100.00
1090529,707771,精測永豐96購06,500,500,0,0.00,100.00
1090529,707772,精測永豐96購07,500,500,0,0.00,100.00
1090529,707773,穩懋永豐96購01,500,500,0,0.00,100.00
1090529,707774,大宇資國票97購01,1000,1000,0,0.00,100.00
1090529,707775,良維國票97購02,1000,1000,0,0.00,100.00
1090529,707776,宜鼎國票97購01,500,500,0,0.00,100.00
1090529,707777,金居國票97購01,500,500,0,0.00,100.00
1090529,707778,信昌電國票97購01,5500,5500,0,0.00,100.00
1090529,707779,保瑞國票97購01,1000,1000,0,0.00,100.00
1090529,707780,昇達科富邦98購01,10000,10000,0,0.00,100.00
1090529,707781,宣德麥證96購01,10000,10000,0,0.00,100.00
1090529,707782,世界台新97購01,5000,5000,0,0.00,100.00
1090529,707783,泰博兆豐96購02,1000,1000,0,0.00,100.00
1090529,707784,聚積康和96購01,1000,1000,0,0.00,100.00
1090529,707785,凡甲群益98購01,2000,2000,0,0.00,100.00
1090529,707786,中美晶群益96購01,600,600,0,0.00,100.00
1090529,707787,合晶群益96購01,500,500,0,0.00,100.00
1090529,707788,晶焱群益98購01,2000,2000,0,0.00,100.00
1090529,707789,精測群益96購04,1200,1200,0,0.00,100.00
1090529,707790,廣明群益96購01,2200,2200,0,0.00,100.00
1090529,707791,聯亞群益96購02,600,600,0,0.00,100.00
1090529,707792,鐿鈦群益97購01,550,550,0,0.00,100.00
1090529,707793,中美晶元大96購02,500,500,0,0.00,100.00
1090529,707794,世界元大96購03,1000,1000,0,0.00,100.00
1090529,707795,精測元大96購02,1000,1000,0,0.00,100.00
1090529,707796,聯亞元大96購02,503,503,0,0.00,100.00
1090529,707797,鈊象元大96購04,500,500,0,0.00,100.00
1090529,707798,世界統一97購01,5000,5000,0,0.00,100.00
1090529,707799,神盾統一98購01,5000,5000,0,0.00,100.00
1090529,707800,穩懋統一98購02,5000,5000,0,0.00,100.00
1090529,707801,鈊象統一97購02,1000,1000,0,0.00,100.00
1090529,707802,宣德中信9A購01,10000,10000,0,0.00,100.00
1090529,707803,中光電凱基96購01,500,500,0,0.00,100.00
1090529,707804,世界凱基96購02,500,500,0,0.00,100.00
1090529,707805,旺矽凱基96購01,500,500,0,0.00,100.00
1090529,707806,信昌電凱基97購02,500,500,0,0.00,100.00
1090529,707807,佳邦國票97購01,1000,1000,0,0.00,100.00
1090529,707808,優群國票98購01,500,500,0,0.00,100.00
1090529,707809,中美晶國泰97購01,600,600,0,0.00,100.00
1090529,707810,穩懋麥證96購01,10000,10000,0,0.00,100.00
1090529,707811,世界元富96購01,2000,2000,0,0.00,100.00
1090529,707812,茂達元富96購01,2000,2000,0,0.00,100.00
1090529,707813,群聯元富96購02,1000,1000,0,0.00,100.00
1090529,707814,穩懋富邦98購01,15000,15000,0,0.00,100.00
1090529,707815,中美晶台新97購01,5000,5000,0,0.00,100.00
1090529,707816,良維台新97購01,5000,5000,0,0.00,100.00
1090529,707817,閎康台新96購01,5000,5000,0,0.00,100.00
1090529,707818,群聯台新97購02,2000,2000,0,0.00,100.00
1090529,707819,碩禾台新97購01,1000,1000,0,0.00,100.00
1090529,707820,世界康和96購01,5000,5000,0,0.00,100.00
1090529,707821,凡甲群益96購01,690,690,0,0.00,100.00
1090529,707822,中美晶群益96購02,600,600,0,0.00,100.00
1090529,707823,宜鼎群益97購01,500,500,0,0.00,100.00
1090529,707824,環球晶群益96購01,850,850,0,0.00,100.00
1090529,707825,鈊象群益99購03,1500,1500,0,0.00,100.00
1090529,707826,大江永豐96購02,500,500,0,0.00,100.00
1090529,707827,世界永豐96購03,500,500,0,0.00,100.00
1090529,707828,合晶永豐96購01,500,500,0,0.00,100.00
1090529,707829,博智永豐96購01,500,500,0,0.00,100.00
1090529,707830,網龍永豐96購01,500,500,0,0.00,100.00
1090529,707831,雙美永豐97購01,3000,3000,0,0.00,100.00
1090529,707832,精測兆豐97購02,1500,1500,0,0.00,100.00
1090529,707833,網龍兆豐97購01,1500,1500,0,0.00,100.00
1090529,707834,晟德兆豐97購01,5000,5000,0,0.00,100.00
1090529,707835,原相康和96購01,1000,1500,-500,-33.33,100.00
1090529,707836,力旺永豐96購01,500,500,0,0.00,100.00
1090529,707837,良維永豐96購02,500,500,0,0.00,100.00
1090529,707838,佳邦永豐96購01,500,500,0,0.00,100.00
1090529,707839,建榮永豐97購01,500,500,0,0.00,100.00
1090529,707840,晶焱永豐97購01,1000,1000,0,0.00,100.00
1090529,707841,智崴永豐96購01,500,500,0,0.00,100.00
1090529,707842,精測永豐96購08,500,500,0,0.00,100.00
1090529,707843,鈊象永豐96購04,500,500,0,0.00,100.00
1090529,707844,中美晶元大97購01,5000,5000,0,0.00,100.00
1090529,707845,台半元大96購01,5000,5000,0,0.00,100.00
1090529,707846,杰力元大96購03,500,500,0,0.00,100.00
1090529,707847,宣德元大96購04,1000,1000,0,0.00,100.00
1090529,707848,精測元大96購03,1000,1000,0,0.00,100.00
1090529,707849,雙鴻元大99購01,5000,5000,0,0.00,100.00
1090529,707850,鈊象元大97購03,500,500,0,0.00,100.00
1090529,707851,群聯麥證96購01,556,556,0,0.00,100.00
1090529,707852,環球晶麥證96購01,10000,10000,0,0.00,100.00
1090529,707853,雙鴻麥證97購01,1000,1000,0,0.00,100.00
1090529,707854,合晶台新96購01,5000,5000,0,0.00,100.00
1090529,707855,良維台新97購02,5000,5000,0,0.00,100.00
1090529,707856,神盾台新97購01,5000,5000,0,0.00,100.00
1090529,707857,新普台新97購01,5000,5000,0,0.00,100.00
1090529,707858,穩懋台新97購01,5000,5000,0,0.00,100.00
1090529,707859,中美晶國票97購01,500,500,0,0.00,100.00
1090529,707860,同致國票97購02,1000,1000,0,0.00,100.00
1090529,707861,東隆興國票96購01,1000,1000,0,0.00,100.00
1090529,707862,茂達國票97購01,1000,1000,0,0.00,100.00
1090529,707863,穩懋國票97購01,500,500,0,0.00,100.00
1090529,707864,M31凱基98購01,500,500,0,0.00,100.00
1090529,707865,中美晶凱基96購03,500,500,0,0.00,100.00
1090529,707866,合晶凱基96購01,500,500,0,0.00,100.00
1090529,707867,宣德凱基96購02,500,500,0,0.00,100.00
1090529,707868,碩禾凱基97購01,500,500,0,0.00,100.00
1090529,707869,精測凱基96購07,500,500,0,0.00,100.00
1090529,707870,聯亞凱基97購01,500,500,0,0.00,100.00
1090529,707871,精測國泰97購02,500,500,0,0.00,100.00
1090529,707872,精測國泰98購03,500,500,0,0.00,100.00
1090529,707873,鈺太國泰98購01,5000,5000,0,0.00,100.00
1090529,707874,世界富邦98購01,15000,15000,0,0.00,100.00
1090529,707875,世界群益98購01,3000,3000,0,0.00,100.00
1090529,707876,世界群益98購02,3000,3000,0,0.00,100.00
1090529,707877,迅得群益97購02,500,500,0,0.00,100.00
1090529,707878,信昌電群益96購01,950,950,0,0.00,100.00
1090529,707879,宣德群益96購02,2000,2000,0,0.00,100.00
1090529,707880,建榮群益97購01,1700,1700,0,0.00,100.00
1090529,707881,璟德群益97購01,1400,1400,0,0.00,100.00
1090529,707882,環球晶群益97購01,650,650,0,0.00,100.00
1090529,707883,力旺元大97購01,1000,1000,0,0.00,100.00
1090529,707884,中美晶元大97購02,6000,6000,0,0.00,100.00
1090529,707885,台燿元大96購01,1000,1000,0,0.00,100.00
1090529,707886,旺矽元大99購01,1000,1000,0,0.00,100.00
1090529,707887,晶焱元大97購02,1000,1000,0,0.00,100.00
1090529,707888,精測元大97購02,1000,1000,0,0.00,100.00
1090529,707889,璟德元大96購02,1000,1000,0,0.00,100.00
1090529,707890,穩懋元大96購04,500,500,0,0.00,100.00
1090529,707891,力旺凱基96購01,500,500,0,0.00,100.00
1090529,707892,大江凱基96購02,1000,1000,0,0.00,100.00
1090529,707893,保瑞凱基96購01,531,531,0,0.00,100.00
1090529,707894,璟德凱基96購02,500,500,0,0.00,100.00
1090529,707895,穩懋凱基96購09,500,500,0,0.00,100.00
1090529,707896,中美晶統一96購01,5000,5000,0,0.00,100.00
1090529,707898,台燿兆豐97購01,5000,5000,0,0.00,100.00
1090529,707899,威剛群益96購01,1000,1000,0,0.00,100.00
1090529,707900,宣德群益96購03,3000,3000,0,0.00,100.00
1090529,707901,精測群益96購05,610,610,0,0.00,100.00
1090529,707902,鈊象群益98購01,1700,1700,0,0.00,100.00
1090529,707903,M31永豐96購01,548,548,0,0.00,100.00
1090529,707904,金居永豐96購01,500,500,0,0.00,100.00
1090529,707905,宣德永豐96購01,500,500,0,0.00,100.00
1090529,707906,精測永豐96購09,500,500,0,0.00,100.00
1090529,707907,璟德永豐96購02,500,500,0,0.00,100.00
1090529,707908,優群永豐96購02,500,500,0,0.00,100.00
1090529,707909,凡甲台新96購01,1000,1000,0,0.00,100.00
1090529,707910,力旺國票97購01,1000,1000,0,0.00,100.00
1090529,707911,杰力國票97購02,1000,1000,0,0.00,100.00
1090529,707912,聚積國票97購01,1000,1000,0,0.00,100.00
1090529,707913,鈊象國票97購01,500,500,0,0.00,100.00
1090529,707914,環球晶國泰97購01,2512,2512,0,0.00,100.00
1090529,707915,中美晶富邦97購02,10000,10000,0,0.00,100.00
1090529,707916,聯亞富邦98購01,10000,10000,0,0.00,100.00
1090529,707917,中美晶麥證96購01,10000,10000,0,0.00,100.00
1090529,707918,合晶麥證96購01,5000,5000,0,0.00,100.00
1090529,707919,櫃200第一96購03,5000,5000,0,0.00,100.00
1090529,707920,櫃200第一96購04,5000,5000,0,0.00,100.00
1090529,707921,譜瑞兆豐96購01,5000,5000,0,0.00,100.00
1090529,707922,雍智康和96購01,1000,1000,0,0.00,100.00
1090529,707923,力旺群益97購01,1500,1500,0,0.00,100.00
1090529,707924,中美晶群益97購01,1899,1899,0,0.00,100.00
1090529,707925,信驊群益96購01,900,900,0,0.00,100.00
1090529,707926,雍智群益96購01,1000,1000,0,0.00,100.00
1090529,707927,碩禾群益97購01,800,800,0,0.00,100.00
1090529,707928,環球晶群益97購02,550,550,0,0.00,100.00
1090529,707929,凡甲元大98購01,500,500,0,0.00,100.00
1090529,707930,雍智元大97購01,1500,1500,0,0.00,100.00
1090529,707931,力旺統一96購01,8000,8000,0,0.00,100.00
1090529,707932,雍智統一97購01,1000,1000,0,0.00,100.00
1090529,707933,新普中信96購01,5000,5000,0,0.00,100.00
1090529,707934,雍智中信96購01,1000,1500,-500,-33.33,100.00
1090529,707935,大江國票97購03,500,500,0,0.00,100.00
1090529,707936,世界國票97購02,500,500,0,0.00,100.00
1090529,707937,雍智國票96購01,1000,1000,0,0.00,100.00
1090529,707938,雙鴻國票97購01,1500,1500,0,0.00,100.00
1090529,707939,鈺太國票97購01,700,700,0,0.00,100.00
1090529,707940,弘塑凱基97購01,1683,1683,0,0.00,100.00
1090529,707941,同致凱基97購01,500,500,0,0.00,100.00
1090529,707942,神盾凱基98購01,500,500,0,0.00,100.00
1090529,707943,雍智凱基96購01,500,500,0,0.00,100.00
1090529,707944,廣明凱基96購01,500,500,0,0.00,100.00
1090529,707945,環球晶凱基96購05,500,500,0,0.00,100.00
1090529,707946,鈊象凱基96購03,500,500,0,0.00,100.00
1090529,707947,力旺麥證96購01,10000,10000,0,0.00,100.00
1090529,707948,威剛國泰97購01,500,500,0,0.00,100.00
1090529,707949,群聯國泰98購01,930,930,0,0.00,100.00
1090529,707950,雍智國泰98購01,600,600,0,0.00,100.00
1090529,707951,精測元富99購01,2500,2500,0,0.00,100.00
1090529,707952,聯亞元富96購02,1000,1000,0,0.00,100.00
1090529,707953,力旺台新97購01,5000,5000,0,0.00,100.00
1090529,707954,世界台新97購02,5000,5000,0,0.00,100.00
1090529,707955,櫃200永昌97購01,505,505,0,0.00,100.00
1090529,707956,櫃200永昌99購01,500,500,0,0.00,100.00
1090529,707957,櫃200永昌99購02,500,500,0,0.00,100.00
1090529,707958,櫃200永昌99購03,500,500,0,0.00,100.00
1090529,707959,久元永豐96購01,500,500,0,0.00,100.00
1090529,707960,立端永豐96購01,1000,1000,0,0.00,100.00
1090529,707961,良維永豐96購03,500,500,0,0.00,100.00
1090529,707962,宜鼎永豐96購01,500,500,0,0.00,100.00
1090529,707963,皇田永豐96購01,500,500,0,0.00,100.00
1090529,707964,美琪瑪永豐96購01,500,500,0,0.00,100.00
1090529,707965,雍智永豐96購01,700,1000,-300,-30.00,100.00
1090529,707966,穩懋統一96購08,5000,5000,0,0.00,100.00
1090529,707967,穩懋統一96購09,5000,5000,0,0.00,100.00
1090529,707968,穩懋統一96購10,5000,5000,0,0.00,100.00
1090529,707969,穩懋統一97購03,5000,5000,0,0.00,100.00
1090529,707970,鈊象統一97購03,1000,1000,0,0.00,100.00
1090529,707971,中美晶中信96購01,5000,5000,0,0.00,100.00
1090529,707972,同致中信98購01,5000,5000,0,0.00,100.00
1090529,707973,環球晶中信9C購01,10000,10000,0,0.00,100.00
1090529,707974,世界凱基96購03,500,500,0,0.00,100.00
1090529,707975,金居凱基96購02,500,500,0,0.00,100.00
1090529,707976,環球晶凱基96購06,500,500,0,0.00,100.00
1090529,707977,穩懋凱基96購10,500,500,0,0.00,100.00
1090529,707978,大江群益97購01,1976,1976,0,0.00,100.00
1090529,707979,原相群益98購01,842,842,0,0.00,100.00
1090529,707980,弘塑國票97購01,1500,1500,0,0.00,100.00
1090529,707981,宜鼎國票97購02,700,700,0,0.00,100.00
1090529,707983,環球晶國票97購01,500,500,0,0.00,100.00
1090529,707984,緯軟國泰97購01,500,500,0,0.00,100.00
1090529,707985,櫃200永昌9B購01,500,500,0,0.00,100.00
1090529,707986,櫃200永昌9C購01,500,500,0,0.00,100.00
1090529,707987,櫃200永昌9C購02,500,500,0,0.00,100.00
1090529,707988,櫃200永昌9C購03,507,507,0,0.00,100.00
1090529,707989,大宇資第一96購01,5000,5000,0,0.00,100.00
1090529,707990,凡甲永豐96購01,500,500,0,0.00,100.00
1090529,707991,弘塑永豐96購01,586,586,0,0.00,100.00
1090529,707992,昇達科永豐96購01,500,500,0,0.00,100.00
1090529,707993,波若威永豐97購01,500,500,0,0.00,100.00
1090529,707994,威剛永豐96購02,1210,1210,0,0.00,100.00
1090529,707995,原相永豐96購01,500,500,0,0.00,100.00
1090529,707996,神盾永豐96購01,551,551,0,0.00,100.00
1090529,707997,網龍永豐96購02,506,506,0,0.00,100.00
1090529,707998,廣明永豐96購02,1000,1000,0,0.00,100.00
1090529,707999,聯亞永豐96購01,500,500,0,0.00,100.00
1090529,708000,雙鴻永豐97購01,1602,1602,0,0.00,100.00
1090529,708001,世界元大96購05,1500,1500,0,0.00,100.00
1090529,708002,合晶元大97購02,1000,1000,0,0.00,100.00
1090529,708003,宜鼎元大96購01,500,500,0,0.00,100.00
1090529,708004,雍智元大97購02,2000,2000,0,0.00,100.00
1090529,708005,精測元大97購03,4000,4000,0,0.00,100.00
1090529,708006,精華元大96購03,1050,1050,0,0.00,100.00
1090529,708007,雍智元富96購01,1000,1000,0,0.00,100.00
1090529,708008,精測元富96購03,1000,1000,0,0.00,100.00
1090529,708009,精測台新96購01,1000,1000,0,0.00,100.00
1090529,708010,璟德台新96購01,5000,5000,0,0.00,100.00
1090529,708011,良維兆豐97購01,5000,5000,0,0.00,100.00
1090529,708012,聚積兆豐97購01,1500,1500,0,0.00,100.00
1090529,708013,廣明兆豐96購01,5000,5000,0,0.00,100.00
1090529,708014,聯亞兆豐97購01,1000,1000,0,0.00,100.00
1090529,708015,鈺太康和96購01,500,500,0,0.00,100.00
1090529,708016,新普群益98購02,1500,1500,0,0.00,100.00
1090529,708017,精測群益96購06,1600,1600,0,0.00,100.00
1090529,708018,雙鴻群益98購01,500,500,0,0.00,100.00
1090529,708019,世界麥證96購01,15000,15000,0,0.00,100.00
1090529,708020,世界元富96購02,2000,2000,0,0.00,100.00
1090529,708021,勝麗元富96購01,1000,1000,0,0.00,100.00
1090529,708022,璟德元富96購01,3000,3000,0,0.00,100.00
1090529,708023,鈺太元富96購01,1000,1000,0,0.00,100.00
1090529,708024,金居中信9C購01,15000,5000,10000,200.00,100.00
1090529,708025,勝麗中信9A購01,10000,10000,0,0.00,100.00
1090529,708026,群聯永豐96購01,1000,1000,0,0.00,100.00
1090529,708027,精測永豐96購10,500,500,0,0.00,100.00
1090529,708028,鈺太永豐96購01,500,500,0,0.00,100.00
1090529,708029,旺矽國票97購01,1500,1500,0,0.00,100.00
1090529,708030,精華國票97購01,500,500,0,0.00,100.00
1090529,708031,中美晶凱基96購04,500,500,0,0.00,100.00
1090529,708032,六角凱基97購01,500,500,0,0.00,100.00
1090529,708034,勝麗凱基96購01,500,500,0,0.00,100.00
1090529,708035,博智凱基96購01,500,500,0,0.00,100.00
1090529,708036,優群凱基98購01,500,500,0,0.00,100.00
1090529,708037,環球晶凱基96購07,500,500,0,0.00,100.00
1090529,708038,穩懋凱基96購11,500,500,0,0.00,100.00
1090529,708039,宣德國泰98購01,500,500,0,0.00,100.00
1090529,708040,雍智國泰98購02,500,500,0,0.00,100.00
1090529,708041,精測國泰98購04,696,696,0,0.00,100.00
1090529,708042,精測國泰99購01,500,500,0,0.00,100.00
1090529,708043,精測國泰9A購01,3885,3885,0,0.00,100.00
1090529,708044,雙鴻富邦97購02,1000,1000,0,0.00,100.00
1090529,708045,大江元大97購02,1800,1800,0,0.00,100.00
1090529,708046,中美晶元大96購03,10000,10000,0,0.00,100.00
1090529,708047,世界元大96購06,6000,6000,0,0.00,100.00
1090529,708048,合晶元大96購05,500,500,0,0.00,100.00
1090529,708049,信驊元大96購01,10000,10000,0,0.00,100.00
1090529,708050,雍智元大96購01,600,600,0,0.00,100.00
1090529,708051,精測元大96購04,1000,1000,0,0.00,100.00
1090529,708052,穩懋元大96購05,600,600,0,0.00,100.00
1090529,708053,鈺太元大97購02,1000,1000,0,0.00,100.00
1090529,708054,力旺元富96購01,2000,2000,0,0.00,100.00
1090529,708055,金可中信9A購01,5000,5000,0,0.00,100.00
1090529,708056,聖暉統一99購01,5000,5000,0,0.00,100.00
1090529,708057,大江凱基98購01,3467,3467,0,0.00,100.00
1090529,708058,良維凱基98購01,500,500,0,0.00,100.00
1090529,708059,旺矽凱基98購01,500,500,0,0.00,100.00
1090529,708060,信驊凱基96購02,500,500,0,0.00,100.00
1090529,708061,雍智凱基98購01,500,500,0,0.00,100.00
1090529,708062,精測凱基99購01,2929,2929,0,0.00,100.00
1090529,708063,緯軟凱基98購01,500,500,0,0.00,100.00
1090529,708064,環球晶凱基96購08,591,591,0,0.00,100.00
1090529,708065,力旺永豐96購02,500,700,-200,-28.57,100.00
1090529,708066,同致永豐96購01,500,500,0,0.00,100.00
1090529,708067,迅得永豐97購02,500,500,0,0.00,100.00
1090529,708068,欣銓永豐96購01,500,500,0,0.00,100.00
1090529,708069,弘塑康和9C購01,15000,15000,0,0.00,100.00
1090529,708070,大田群益96購01,1300,1300,0,0.00,100.00
1090529,708071,合晶群益96購02,1400,1400,0,0.00,100.00
1090529,708072,信昌電群益96購02,650,650,0,0.00,100.00
1090529,708073,茂達群益98購01,700,700,0,0.00,100.00
1090529,708074,大宇資國票97購02,5000,5000,0,0.00,100.00
1090529,708075,雙鴻國票97購02,1000,1000,0,0.00,100.00
1090529,708076,力旺國泰98購01,680,680,0,0.00,100.00
1090529,708077,威剛富邦98購01,10000,10000,0,0.00,100.00
1090529,708078,勝麗富邦97購01,10000,10000,0,0.00,100.00
1090529,708079,群聯富邦98購01,2279,2279,0,0.00,100.00
1090529,708080,精測富邦97購01,10000,10000,0,0.00,100.00
1090529,708081,信驊元大96購02,5000,5000,0,0.00,100.00
1090529,708082,新普元大97購01,1500,1500,0,0.00,100.00
1090529,708083,環球晶元大96購03,5000,5000,0,0.00,100.00
1090529,708084,環球晶元大97購01,1000,1000,0,0.00,100.00
1090529,708085,穩懋元大96購06,1000,1000,0,0.00,100.00
1090529,708086,穩懋元大96購07,800,800,0,0.00,100.00
1090529,708087,群聯元富96購03,1000,1000,0,0.00,100.00
1090529,708088,群聯兆豐97購01,1500,1500,0,0.00,100.00
1090529,708089,精測兆豐97購03,1000,1000,0,0.00,100.00
1090529,708090,穩懋兆豐96購04,5000,5000,0,0.00,100.00
1090529,708091,久元康和96購01,1000,5000,-4000,-80.00,100.00
1090529,708092,櫃200永昌98購01,512,512,0,0.00,100.00
1090529,708093,櫃200永昌98購02,500,500,0,0.00,100.00
1090529,708094,大學光群益98購01,1200,1200,0,0.00,100.00
1090529,708095,VHQ中信96購01,5000,5000,0,0.00,100.00
1090529,708096,合晶中信9A購01,5000,5000,0,0.00,100.00
1090529,708097,宣德中信9A購02,10000,10000,0,0.00,100.00
1090529,708098,群聯中信9A購01,5000,5000,0,0.00,100.00
1090529,708099,M31凱基97購02,610,610,0,0.00,100.00
1090529,708100,大江凱基96購03,500,500,0,0.00,100.00
1090529,708101,合晶凱基97購01,500,500,0,0.00,100.00
1090529,708102,良維凱基97購01,500,500,0,0.00,100.00
1090529,708103,宜鼎凱基96購02,500,500,0,0.00,100.00
1090529,708104,晶焱凱基98購01,500,500,0,0.00,100.00
1090529,708105,旺矽統一97購01,1000,5000,-4000,-80.00,100.00
1090529,708106,宣德統一97購02,5000,5000,0,0.00,100.00
1090529,708107,大江永豐96購03,500,500,0,0.00,100.00
1090529,708109,昇達科永豐96購02,1000,1000,0,0.00,100.00
1090529,708110,博智永豐96購02,500,500,0,0.00,100.00
1090529,708111,新鉅科永豐96購01,500,500,0,0.00,100.00
1090529,708112,晟德永豐96購01,500,500,0,0.00,100.00
1090529,708113,世界元大96購07,1500,1500,0,0.00,100.00
1090529,708114,良維元大97購02,500,500,0,0.00,100.00
1090529,708115,佳邦元大96購01,500,500,0,0.00,100.00
1090529,708117,廣明元大97購01,500,500,0,0.00,100.00
1090529,708118,環球晶元大96購04,500,500,0,0.00,100.00
1090529,708119,環球晶元大97購02,1000,1000,0,0.00,100.00
1090529,708120,穩懋元大96購10,600,600,0,0.00,100.00
1090529,708121,M31國票97購01,500,500,0,0.00,100.00
1090529,708122,六角國票98購02,1000,1000,0,0.00,100.00
1090529,708123,原相國票97購01,1000,1000,0,0.00,100.00
1090529,708124,神盾國票97購02,1000,1000,0,0.00,100.00
1090529,708125,碩禾國票97購01,1000,5000,-4000,-80.00,100.00
1090529,708126,環宇國票97購01,1000,1000,0,0.00,100.00
1090529,708128,環球晶國泰97購02,500,500,0,0.00,100.00
1090529,708129,力旺元大96購01,8000,8000,0,0.00,100.00
1090529,708130,台燿元大96購02,10000,10000,0,0.00,100.00
1090529,708131,泰博元大96購01,1000,1000,0,0.00,100.00
1090529,708132,博智元大97購01,1000,1000,0,0.00,100.00
1090529,708133,網家元大96購01,874,874,0,0.00,100.00
1090529,708134,穩懋元大96購11,600,600,0,0.00,100.00
1090529,708135,群聯群益96購04,666,666,0,0.00,100.00
1090529,708136,宇峻凱基98購02,500,500,0,0.00,100.00
1090529,708137,旺矽凱基97購01,5500,5500,0,0.00,100.00
1090529,708138,原相凱基98購01,500,500,0,0.00,100.00
1090529,708139,精華凱基97購01,500,500,0,0.00,100.00
1090529,708140,優群凱基98購02,500,500,0,0.00,100.00
1090529,708141,鈊象凱基98購02,500,500,0,0.00,100.00
1090529,708142,宣德台新96購02,5000,5000,0,0.00,100.00
1090529,708143,大江永豐97購01,1000,1000,0,0.00,100.00
1090529,708144,杰力永豐96購01,500,500,0,0.00,100.00
1090529,708145,直得永豐96購01,500,500,0,0.00,100.00
1090529,708146,信昌電永豐96購02,500,500,0,0.00,100.00
1090529,708147,保瑞永豐96購01,1000,1000,0,0.00,100.00
1090529,708148,胡連永豐96購01,500,500,0,0.00,100.00
1090529,708149,精測永豐96購12,500,500,0,0.00,100.00
1090529,708150,聚積永豐96購01,1000,1000,0,0.00,100.00
1090529,708151,雙鴻永豐97購02,1000,1000,0,0.00,100.00
1090529,708152,力旺中信96購01,5000,5000,0,0.00,100.00
1090529,708153,建榮統一98購01,10000,10000,0,0.00,100.00
1090529,708154,大江凱基98購02,3921,3921,0,0.00,100.00
1090529,708155,宇峻凱基98購03,500,500,0,0.00,100.00
1090529,708157,金居凱基97購01,500,500,0,0.00,100.00
1090529,708158,鐿鈦凱基96購03,500,500,0,0.00,100.00
1090529,708159,大江元大97購03,500,1000,-500,-50.00,100.00
1090529,708160,合晶元大98購01,6000,6000,0,0.00,100.00
1090529,708162,欣銓元大96購01,1500,1500,0,0.00,100.00
1090529,708163,威剛元大98購01,3438,3438,0,0.00,100.00
1090529,708164,環球晶元大96購05,1310,1310,0,0.00,100.00
1090529,708165,環球晶元大97購03,1250,1250,0,0.00,100.00
1090529,708166,凡甲永豐96購02,500,500,0,0.00,100.00
1090529,708167,台燿永豐96購01,800,1000,-200,-20.00,100.00
1090529,708168,波若威永豐97購02,500,500,0,0.00,100.00
1090529,708169,網家永豐96購01,500,500,0,0.00,100.00
1090529,708170,網龍永豐96購03,500,500,0,0.00,100.00
1090529,708171,優群永豐96購03,500,500,0,0.00,100.00
1090529,708172,緯軟兆豐97購01,5000,5000,0,0.00,100.00
1090529,708173,鈺太兆豐97購01,1000,5000,-4000,-80.00,100.00
1090529,708174,胡連康和96購02,5000,5000,0,0.00,100.00
1090529,708175,精華群益96購02,600,600,0,0.00,100.00
1090529,708176,中美晶國票97購02,500,500,0,0.00,100.00
1090529,708177,欣銓富邦97購01,10000,10000,0,0.00,100.00
1090529,708178,鈊象富邦97購01,1000,7000,-6000,-85.71,100.00
1090529,708179,神盾元富98購01,5000,5000,0,0.00,100.00
1090529,708180,群聯元富96購04,1000,1000,0,0.00,100.00
1090529,708181,VHQ統一96購01,20000,20000,0,0.00,100.00
1090529,708182,凡甲統一96購01,1000,1000,0,0.00,100.00
1090529,708183,中美晶凱基96購05,500,500,0,0.00,100.00
1090529,708184,建榮凱基96購02,500,500,0,0.00,100.00
1090529,708185,原相凱基97購01,500,500,0,0.00,100.00
1090529,708186,神盾凱基96購03,500,500,0,0.00,100.00
1090529,708187,金居兆豐97購01,5000,5000,0,0.00,100.00
1090529,708188,威剛兆豐97購01,1500,5000,-3500,-70.00,100.00
1090529,708189,茂達群益98購02,650,650,0,0.00,100.00
1090529,708190,六角元大96購02,10000,10000,0,0.00,100.00
1090529,708191,同致元大96購02,8000,8000,0,0.00,100.00
1090529,708192,旺矽元大97購01,1000,1000,0,0.00,100.00
1090529,708193,直得元大96購01,1000,1000,0,0.00,100.00
1090529,708194,宣德元大97購01,1000,1000,0,0.00,100.00
1090529,708195,精測元大96購07,1000,1000,0,0.00,100.00
1090529,708196,環宇元大96購02,8000,8000,0,0.00,100.00
1090529,708197,合晶亞東97購01,500,500,0,0.00,100.00
1090529,708198,三貝德永豐96購01,500,500,0,0.00,100.00
1090529,708199,大田永豐96購02,1000,1000,0,0.00,100.00
1090529,708200,中美晶永豐96購03,1000,1000,0,0.00,100.00
1090529,708201,金居永豐96購02,1000,1000,0,0.00,100.00
1090529,708202,碩禾永豐96購01,500,500,0,0.00,100.00
1090529,708203,雙鴻永豐96購02,1000,1000,0,0.00,100.00
1090529,708205,力旺台新97購02,5000,5000,0,0.00,100.00
1090529,708206,大江國票97購04,500,500,0,0.00,100.00
1090529,708207,大學光國票98購01,500,500,0,0.00,100.00
1090529,708208,勝麗國票97購03,1000,1000,0,0.00,100.00
1090529,708209,博智國票97購01,500,500,0,0.00,100.00
1090529,708210,閎康國票97購02,1000,1000,0,0.00,100.00
1090529,708211,精華國票97購02,1000,1000,0,0.00,100.00
1090529,708212,鈺太國泰96購01,1000,1000,0,0.00,100.00
1090529,708213,群聯富邦97購02,1106,1106,0,0.00,100.00
1090529,708214,鈺太統一99購01,5000,5000,0,0.00,100.00
1090529,708215,久元凱基96購01,500,500,0,0.00,100.00
1090529,708216,勝麗凱基98購01,500,500,0,0.00,100.00
1090529,708217,碩禾凱基98購01,500,500,0,0.00,100.00
1090529,708218,中美晶元富96購01,2500,2500,0,0.00,100.00
1090529,708219,新普元富96購01,2000,2000,0,0.00,100.00
1090529,708220,雙鴻台新97購01,1000,5000,-4000,-80.00,100.00
1090529,708221,VHQ康和96購01,15000,15000,0,0.00,100.00
1090529,708222,網家康和96購01,1000,1000,0,0.00,100.00
1090529,708223,台半群益96購01,500,500,0,0.00,100.00
1090529,708224,良維群益96購01,500,500,0,0.00,100.00
1090529,708226,信昌電群益96購03,900,900,0,0.00,100.00
1090529,708227,鈊象群益99購04,5000,5000,0,0.00,100.00
1090529,708228,波若威永豐96購01,500,500,0,0.00,100.00
1090529,708229,中美晶亞東96購01,1000,1000,0,0.00,100.00
1090529,708230,群聯亞東96購01,950,950,0,0.00,100.00
1090529,708231,六角國票98購03,2000,2000,0,0.00,100.00
1090529,708232,宜鼎國票97購03,500,500,0,0.00,100.00
1090529,708233,宣德國票97購01,2500,3000,-500,-16.66,100.00
1090529,708234,神盾國票98購01,5000,5000,0,0.00,100.00
1090529,708235,璟德國票97購01,3000,3000,0,0.00,100.00
1090529,708236,優群國票97購01,500,500,0,0.00,100.00
1090529,708237,環宇國票97購02,1000,1000,0,0.00,100.00
1090529,708238,三貝德元大97購01,10000,10000,0,0.00,100.00
1090529,708239,中美晶元大96購04,500,500,0,0.00,100.00
1090529,708240,宇峻元大97購02,500,500,0,0.00,100.00
1090529,708241,聯亞元大97購02,500,500,0,0.00,100.00
1090529,708242,穩懋元大97購02,1000,1000,0,0.00,100.00
1090529,708243,譜瑞元大97購01,8000,8000,0,0.00,100.00
1090529,708244,原相國泰98購02,500,500,0,0.00,100.00
1090529,708245,勝麗國泰98購01,1000,1000,0,0.00,100.00
1090529,708246,網家國泰97購02,500,500,0,0.00,100.00
1090529,708247,原相第一96購01,1000,1000,0,0.00,100.00
1090529,708248,波若威凱基98購01,500,500,0,0.00,100.00
1090529,708249,雙鴻凱基98購01,972,972,0,0.00,100.00
1090529,708250,穩懋凱基96購12,500,500,0,0.00,100.00
1090529,708251,頎邦凱基97購01,5500,5500,0,0.00,100.00
1090529,708252,頎邦凱基97購02,6225,6225,0,0.00,100.00
1090529,708253,大江元富96購02,1000,1000,0,0.00,100.00
1090529,708254,頎邦元富96購01,1000,1000,0,0.00,100.00
1090529,708255,頎邦元富96購02,1000,1000,0,0.00,100.00
1090529,708256,信昌電永豐96購03,500,500,0,0.00,100.00
1090529,708257,頎邦永豐96購02,500,500,0,0.00,100.00
1090529,708258,頎邦永豐96購03,1000,1000,0,0.00,100.00
1090529,708259,神盾統一96購01,1000,1000,0,0.00,100.00
1090529,708260,群聯統一98購01,5000,5000,0,0.00,100.00
1090529,708261,頎邦統一96購01,5000,5000,0,0.00,100.00
1090529,708262,合晶國票97購02,1000,1000,0,0.00,100.00
1090529,708263,威剛國票97購01,500,500,0,0.00,100.00
1090529,708264,宣德國票97購02,2500,3000,-500,-16.66,100.00
1090529,708265,聚積國票97購02,1000,1000,0,0.00,100.00
1090529,708266,頎邦國票97購01,500,500,0,0.00,100.00
1090529,708267,M31國泰98購01,500,500,0,0.00,100.00
1090529,708268,聯亞國泰98購01,1950,1950,0,0.00,100.00
1090529,708269,頎邦國泰97購01,500,500,0,0.00,100.00
1090529,708271,原相富邦98購01,10000,10000,0,0.00,100.00
1090529,708272,頎邦富邦98購01,10000,10000,0,0.00,100.00
1090529,708273,力旺元大96購02,1000,1000,0,0.00,100.00
1090529,708274,中美晶元大96購05,1000,1000,0,0.00,100.00
1090529,708275,六角元大98購01,1550,1550,0,0.00,100.00
1090529,708276,台半元大96購02,10000,10000,0,0.00,100.00
1090529,708277,金居元大97購01,691,691,0,0.00,100.00
1090529,708278,勝麗元大96購03,1000,1000,0,0.00,100.00
1090529,708279,頎邦元大96購02,6000,6000,0,0.00,100.00
1090529,708280,頎邦元大96購03,5000,5000,0,0.00,100.00
1090529,708281,頎邦元大97購01,10000,10000,0,0.00,100.00
1090529,708282,兆利群益98購01,700,700,0,0.00,100.00
1090529,708283,頎邦群益97購01,1500,1500,0,0.00,100.00
1090529,708284,頎邦群益97購02,1500,1500,0,0.00,100.00
1090529,708285,頎邦群益98購01,5500,5500,0,0.00,100.00
1090529,708286,三貝德康和96購01,5000,5000,0,0.00,100.00
1090529,708287,兆利康和9C購01,5000,5000,0,0.00,100.00
1090529,708288,富喬康和96購01,5000,5000,0,0.00,100.00
1090529,708289,杰力群益96購01,1700,1700,0,0.00,100.00
1090529,708290,威剛群益97購01,2009,2009,0,0.00,100.00
1090529,708291,環宇群益98購01,900,900,0,0.00,100.00
1090529,708292,M31國票97購02,500,500,0,0.00,100.00
1090529,708293,合晶國票98購01,1000,1000,0,0.00,100.00
1090529,708294,良維國票97購03,1500,1500,0,0.00,100.00
1090529,708296,威剛國票97購02,2662,2662,0,0.00,100.00
1090529,708297,茂達國票97購02,1000,1000,0,0.00,100.00
1090529,708298,原相國票98購02,500,500,0,0.00,100.00
1090529,708299,穩懋國票97購02,1000,1000,0,0.00,100.00
1090529,708300,群聯日盛96購01,10000,10000,0,0.00,100.00
1090529,708301,優群永豐97購01,500,500,0,0.00,100.00
1090529,708302,穩懋永豐96購02,1000,1000,0,0.00,100.00
1090529,708303,伍豐中信9A購01,10000,10000,0,0.00,100.00
1090529,708304,同致中信98購02,5000,5000,0,0.00,100.00
1090529,708305,宜鼎中信9A購01,10000,10000,0,0.00,100.00
1090529,708306,閎康統一99購01,5000,5000,0,0.00,100.00
1090529,708307,頎邦統一96購02,5000,5000,0,0.00,100.00
1090529,708308,大中凱基98購01,500,500,0,0.00,100.00
1090529,708309,大江凱基97購01,500,500,0,0.00,100.00
1090529,708310,兆利凱基98購01,681,681,0,0.00,100.00
1090529,708311,迅得凱基97購01,500,500,0,0.00,100.00
1090529,708312,佳邦凱基98購01,500,500,0,0.00,100.00
1090529,708313,金居凱基98購01,500,500,0,0.00,100.00
1090529,708314,聚積凱基98購01,500,500,0,0.00,100.00
1090529,708315,廣明凱基98購01,500,500,0,0.00,100.00
1090529,708316,緯軟凱基98購02,500,500,0,0.00,100.00
1090529,708317,環宇凱基98購01,500,500,0,0.00,100.00
1090529,708318,聯亞凱基98購01,500,500,0,0.00,100.00
1090529,708319,穩懋凱基96購13,500,500,0,0.00,100.00
1090529,708320,頎邦凱基96購01,500,500,0,0.00,100.00
1090529,708321,大學光元大97購01,500,500,0,0.00,100.00
1090529,708322,群聯元大97購04,649,649,0,0.00,100.00
1090529,708323,聯亞元大97購03,500,500,0,0.00,100.00
1090529,708324,新普兆豐97購01,5000,5000,0,0.00,100.00
1090529,708325,穩懋兆豐97購02,5000,5000,0,0.00,100.00
1090529,708326,大江日盛96購01,3000,3000,0,0.00,100.00
1090529,708327,鈊象第一96購01,1000,1000,0,0.00,100.00
1090529,708328,晶焱元大97購03,1000,1000,0,0.00,100.00
1090529,708329,頎邦康和96購01,5000,5000,0,0.00,100.00
1090529,708330,M31群益98購01,1600,1600,0,0.00,100.00
1090529,708331,中美晶群益96購03,1111,1111,0,0.00,100.00
1090529,708332,六角群益98購01,800,800,0,0.00,100.00
1090529,708333,宇峻群益98購01,1509,1509,0,0.00,100.00
1090529,708334,佳邦群益98購01,1000,1000,0,0.00,100.00
1090529,708335,網龍群益96購01,600,600,0,0.00,100.00
1090529,708336,大宇資永豐97購01,1000,1000,0,0.00,100.00
1090529,708337,大學光永豐96購02,500,500,0,0.00,100.00
1090529,708338,伍豐永豐96購01,1000,1000,0,0.00,100.00
1090529,708339,旺矽永豐97購02,1000,1000,0,0.00,100.00
1090529,708341,美琪瑪永豐96購02,1000,1000,0,0.00,100.00
1090529,708342,群聯永豐96購02,2000,2000,0,0.00,100.00
1090529,708343,網龍永豐96購04,1000,1000,0,0.00,100.00
1090529,708344,聯亞永豐96購03,500,500,0,0.00,100.00
1090529,708345,鈊象永豐96購05,597,597,0,0.00,100.00
1090529,708346,M31統一97購01,5000,5000,0,0.00,100.00
1090529,708347,環球晶統一96購02,5000,5000,0,0.00,100.00
1090529,708348,環球晶中信96購02,5000,5000,0,0.00,100.00
1090529,708349,鈺太中信97購01,5000,5000,0,0.00,100.00
1090529,708350,中美晶台新97購02,5000,5000,0,0.00,100.00
1090529,708351,穩懋台新97購02,5000,5000,0,0.00,100.00
1090529,708352,杰力凱基98購01,500,500,0,0.00,100.00
1090529,708353,中美晶富邦97購03,10000,10000,0,0.00,100.00
1090529,708354,合晶國票99購01,500,500,0,0.00,100.00
1090529,708355,昇達科國票97購01,1000,1000,0,0.00,100.00
1090529,708356,信昌電國票97購03,1000,1000,0,0.00,100.00
1090529,708357,神盾國票97購03,1000,1000,0,0.00,100.00
1090529,708358,群聯國票97購02,500,500,0,0.00,100.00
1090529,708359,中美晶國泰97購02,500,500,0,0.00,100.00
1090529,708360,宇峻國泰97購01,500,500,0,0.00,100.00
1090529,708361,鈊象國泰98購02,500,500,0,0.00,100.00
1090529,708362,環球晶統一96購04,5000,5000,0,0.00,100.00
1090529,708363,台燿中信98購01,5000,5000,0,0.00,100.00
1090529,708364,新普中信98購01,5000,5000,0,0.00,100.00
1090529,708365,凡甲凱基97購01,500,500,0,0.00,100.00
1090529,708366,中美晶凱基97購01,500,500,0,0.00,100.00
1090529,708367,良維凱基97購02,500,500,0,0.00,100.00
1090529,708368,宣德凱基97購01,500,500,0,0.00,100.00
1090529,708369,雙美凱基98購01,3109,3109,0,0.00,100.00
1090529,708370,中美晶元大96購06,2000,2000,0,0.00,100.00
1090529,708371,信昌電元大96購04,500,500,0,0.00,100.00
1090529,708372,優群元大97購03,1000,1000,0,0.00,100.00
1090529,708373,中美晶元富96購02,3500,3500,0,0.00,100.00
1090529,708374,久元台新96購01,1000,5000,-4000,-80.00,100.00
1090529,708375,久元台新96購02,1000,5000,-4000,-80.00,100.00
1090529,708376,台半台新96購01,5000,5000,0,0.00,100.00
1090529,708377,鈊象台新96購02,1000,1000,0,0.00,100.00
1090529,708378,頎邦台新97購01,5000,5000,0,0.00,100.00
1090529,708379,穩懋亞東98購01,2300,2300,0,0.00,100.00
1090529,708380,台半永豐96購01,1000,1000,0,0.00,100.00
1090529,708381,亞泰永豐96購01,1000,1000,0,0.00,100.00
1090529,708382,宜鼎永豐96購02,1000,1000,0,0.00,100.00
1090529,708383,信昌電永豐96購04,518,518,0,0.00,100.00
1090529,708384,雍智永豐97購01,1074,1074,0,0.00,100.00
1090529,708385,碩禾永豐96購02,536,536,0,0.00,100.00
1090529,708386,雙鴻永豐97購03,500,500,0,0.00,100.00
1090529,708387,瓦城康和96購01,5000,5000,0,0.00,100.00
1090529,708388,三貝德群益96購02,1800,1800,0,0.00,100.00
1090529,708389,台半群益96購02,500,500,0,0.00,100.00
1090529,708390,美琪瑪群益96購01,800,800,0,0.00,100.00
1090529,708391,原相群益98購02,2595,2595,0,0.00,100.00
1090529,708392,大江國票97購05,500,500,0,0.00,100.00
1090529,708393,信昌電國泰98購01,500,500,0,0.00,100.00
1090529,708394,威剛國泰98購01,670,670,0,0.00,100.00
1090529,708395,環球晶國泰97購03,500,500,0,0.00,100.00
1090529,708396,信昌電富邦98購01,6000,6000,0,0.00,100.00
1090529,708397,群聯富邦97購03,6000,6000,0,0.00,100.00
1090529,708398,環球晶富邦99購01,20000,20000,0,0.00,100.00
1090529,708399,穩懋富邦97購03,1184,1184,0,0.00,100.00
1090529,708400,建榮國票98購01,1000,1000,0,0.00,100.00
1090529,708401,威剛國泰98購02,500,500,0,0.00,100.00
1090529,708402,優群國泰99購01,500,500,0,0.00,100.00
1090529,708403,合晶元大98購02,1000,1000,0,0.00,100.00
1090529,708404,聖暉元大97購01,1500,1500,0,0.00,100.00
1090529,708405,頎邦元大97購02,6000,6000,0,0.00,100.00
1090529,708407,環球晶元富97購01,5000,5000,0,0.00,100.00
1090529,708408,雙鴻統一97購01,1000,1000,0,0.00,100.00
1090529,708409,精測中信97購01,1500,1500,0,0.00,100.00
1090529,708410,頎邦中信9B購01,10000,10000,0,0.00,100.00
1090529,708411,宜鼎凱基99購01,500,500,0,0.00,100.00
1090529,708412,直得凱基98購01,544,544,0,0.00,100.00
1090529,708413,信昌電凱基98購01,500,500,0,0.00,100.00
1090529,708414,群聯凱基98購01,2100,2100,0,0.00,100.00
1090529,708415,VHQ永豐97購01,500,500,0,0.00,100.00
1090529,708416,大宇資永豐99購01,1000,1000,0,0.00,100.00
1090529,708417,長科*永豐97購01,500,500,0,0.00,100.00
1090529,708418,廣明永豐97購01,4000,4000,0,0.00,100.00
1090529,708419,環宇永豐98購01,518,518,0,0.00,100.00
1090529,708420,宜鼎群益98購01,500,500,0,0.00,100.00
1090529,708421,群聯群益98購01,500,500,0,0.00,100.00
1090529,708422,群聯群益99購01,500,500,0,0.00,100.00
1090529,708423,世界麥證97購01,20000,20000,0,0.00,100.00
1090529,708424,原相台新97購02,5000,5000,0,0.00,100.00
1090529,708425,新鉅科台新98購01,5000,5000,0,0.00,100.00
1090529,708426,群聯台新97購03,500,500,0,0.00,100.00
1090529,708427,聯亞台新97購01,1000,1000,0,0.00,100.00
1090529,708428,鈺太台新97購01,1000,1000,0,0.00,100.00
1090529,708429,群聯統一97購01,1000,1000,0,0.00,100.00
1090529,708430,兆利中信9A購01,10000,10000,0,0.00,100.00
1090529,708431,原相中信99購01,5000,5000,0,0.00,100.00
1090529,708432,廣明中信9B購01,20000,20000,0,0.00,100.00
1090529,708433,穩懋中信99購01,5000,5000,0,0.00,100.00
1090529,708434,合晶凱基98購01,500,500,0,0.00,100.00
1090529,708435,勝麗凱基97購02,500,500,0,0.00,100.00
1090529,708436,博智凱基97購01,500,500,0,0.00,100.00
1090529,708437,穩懋日盛97購01,10000,10000,0,0.00,100.00
1090529,708438,中美晶亞東97購01,1300,1300,0,0.00,100.00
1090529,708439,合晶亞東97購02,1000,1000,0,0.00,100.00
1090529,708440,大田元富97購01,2000,2000,0,0.00,100.00
1090529,708441,榮剛元富97購01,5000,5000,0,0.00,100.00
1090529,708442,聯亞台新99購01,5000,5000,0,0.00,100.00
1090529,708444,威剛元大99購01,1487,1487,0,0.00,100.00
1090529,708445,神盾元大99購02,1000,1000,0,0.00,100.00
1090529,708446,聯亞元大97購04,555,555,0,0.00,100.00
1090529,708447,鈺太元大99購01,1000,1000,0,0.00,100.00
1090529,708448,大中永豐97購01,500,500,0,0.00,100.00
1090529,708449,大江永豐97購02,536,536,0,0.00,100.00
1090529,708450,六角永豐97購01,500,500,0,0.00,100.00
1090529,708451,兆利永豐97購01,1000,1000,0,0.00,100.00
1090529,708452,波若威永豐98購01,500,500,0,0.00,100.00
1090529,708453,宣德永豐97購02,512,512,0,0.00,100.00
1090529,708454,建榮永豐99購01,5000,5000,0,0.00,100.00
1090529,708455,森鉅永豐97購01,1000,1000,0,0.00,100.00
1090529,708456,榮剛永豐97購01,1500,1500,0,0.00,100.00
1090529,708457,廣積永豐97購01,1500,1500,0,0.00,100.00
1090529,708458,旺矽群益9A購01,700,700,0,0.00,100.00
1090529,708459,昇達科群益98購01,2300,2300,0,0.00,100.00
1090529,708460,櫃200群益97購01,500,500,0,0.00,100.00
1090529,708461,櫃200群益97購02,500,500,0,0.00,100.00
1090529,708462,中美晶元大97購03,1000,1000,0,0.00,100.00
1090529,708463,宜鼎元大97購01,1000,1000,0,0.00,100.00
1090529,708465,璟德元大97購01,1000,1000,0,0.00,100.00
1090529,708466,璟德元大97購02,1000,1000,0,0.00,100.00
1090529,708467,優群元大97購04,1000,1000,0,0.00,100.00
1090529,708468,兆利康和97購01,5000,5000,0,0.00,100.00
1090529,708469,璟德康和97購01,5000,5000,0,0.00,100.00
1090529,708470,璟德元富97購01,2000,2000,0,0.00,100.00
1090529,708471,璟德台新97購01,5000,5000,0,0.00,100.00
1090529,708472,三貝德凱基99購01,4686,4686,0,0.00,100.00
1090529,708473,大田凱基98購01,500,500,0,0.00,100.00
1090529,708474,中美晶凱基97購02,500,500,0,0.00,100.00
1090529,708475,宇峻凱基9A購01,640,640,0,0.00,100.00
1090529,708476,網龍凱基98購01,500,500,0,0.00,100.00
1090529,708477,鈊象凱基99購01,500,500,0,0.00,100.00
1090529,708478,穩懋日盛97購02,10000,10000,0,0.00,100.00
1090529,708479,立端永豐97購01,1000,1000,0,0.00,100.00
1090529,708480,宇峻永豐97購01,1413,1413,0,0.00,100.00
1090529,708481,迅得永豐97購03,500,500,0,0.00,100.00
1090529,708482,神盾永豐97購01,500,500,0,0.00,100.00
1090529,708483,璟德永豐97購02,500,500,0,0.00,100.00
1090529,708484,璟德國泰98購01,1000,1000,0,0.00,100.00
1090529,708485,六角國票97購01,500,500,0,0.00,100.00
1090529,708487,信昌電國票98購01,500,500,0,0.00,100.00
1090529,708488,威剛國票98購01,500,500,0,0.00,100.00
1090529,708489,群聯國票98購01,1260,1260,0,0.00,100.00
1090529,708490,雍智國票98購01,8000,3000,5000,166.66,100.00
1090529,708491,雙美國票99購01,500,500,0,0.00,100.00
1090529,708492,雙鴻國票98購02,5000,5000,0,0.00,100.00
1090529,708493,鈊象國票98購01,500,500,0,0.00,100.00
1090529,708494,大江群益97購02,1057,1057,0,0.00,100.00
1090529,708495,信昌電群益97購01,2500,2500,0,0.00,100.00
1090529,708496,建榮群益99購01,1700,1700,0,0.00,100.00
1090529,708497,原相群益99購01,500,500,0,0.00,100.00
1090529,708498,勝麗群益98購01,1850,1850,0,0.00,100.00
1090529,708499,璟德群益98購01,600,600,0,0.00,100.00
1090529,708500,鈊象群益99購05,1400,1400,0,0.00,100.00
1090529,708501,力致元大97購01,800,800,0,0.00,100.00
1090529,708502,中美晶元大97購04,1000,1000,0,0.00,100.00
1090529,708503,世禾元大97購01,8000,8000,0,0.00,100.00
1090529,708504,尼克森元大97購01,8000,8000,0,0.00,100.00
1090529,708505,宇峻元大97購03,2400,2400,0,0.00,100.00
1090529,708506,信昌電元大98購01,500,500,0,0.00,100.00
1090529,708507,碩禾元大98購02,500,500,0,0.00,100.00
1090529,708508,雙鴻元大99購02,1000,1000,0,0.00,100.00
1090529,708509,尼克森統一99購01,5000,5000,0,0.00,100.00
1090529,708510,尼克森統一99購02,5000,5000,0,0.00,100.00
1090529,708511,迅得統一99購01,5000,5000,0,0.00,100.00
1090529,708512,頎邦統一97購01,6000,6000,0,0.00,100.00
1090529,708513,M31中信98購01,5000,5000,0,0.00,100.00
1090529,708514,大中中信97購01,10000,10000,0,0.00,100.00
1090529,708515,宇峻中信97購01,5000,5000,0,0.00,100.00
1090529,708516,博智中信97購01,1000,1000,0,0.00,100.00
1090529,708517,大中凱基98購02,500,500,0,0.00,100.00
1090529,708518,同致凱基98購01,500,500,0,0.00,100.00
1090529,708519,合晶凱基97購02,500,500,0,0.00,100.00
1090529,708520,朋億凱基97購01,500,500,0,0.00,100.00
1090529,708521,南光凱基97購01,500,500,0,0.00,100.00
1090529,708522,緯軟凱基98購03,500,500,0,0.00,100.00
1090529,708523,大江兆豐97購01,1000,1000,0,0.00,100.00
1090529,708524,中美晶兆豐98購01,5000,5000,0,0.00,100.00
1090529,708525,台燿兆豐97購02,5000,5000,0,0.00,100.00
1090529,708526,精華兆豐98購01,5000,5000,0,0.00,100.00
1090529,708527,中美晶群益97購03,500,500,0,0.00,100.00
1090529,708528,太景*群益98購01,4593,4593,0,0.00,100.00
1090529,708529,立端群益97購01,1000,1000,0,0.00,100.00
1090529,708530,朋億群益98購01,1500,1500,0,0.00,100.00
1090529,708531,欣銓群益98購01,1400,1400,0,0.00,100.00
1090529,708532,群聯群益97購02,1895,1895,0,0.00,100.00
1090529,708533,緯軟群益98購01,2500,2500,0,0.00,100.00
1090529,708534,環球晶群益97購03,526,526,0,0.00,100.00
1090529,708535,譜瑞群益97購01,500,500,0,0.00,100.00
1090529,708536,建榮國票98購02,1000,1000,0,0.00,100.00
1090529,708537,力致國泰99購01,900,900,0,0.00,100.00
1090529,708538,凡甲國泰99購01,1000,1000,0,0.00,100.00
1090529,708539,中菲行國泰98購01,500,500,0,0.00,100.00
1090529,708540,世禾國泰98購01,1000,1000,0,0.00,100.00
1090529,708541,尼克森國泰99購01,1000,1000,0,0.00,100.00
1090529,708542,幃翔國泰98購01,550,550,0,0.00,100.00
1090529,708543,幃翔國泰98購02,500,500,0,0.00,100.00
1090529,708544,群聯國泰99購01,3410,3410,0,0.00,100.00
1090529,708545,雙鴻國泰99購01,660,660,0,0.00,100.00
1090529,708546,力致永豐97購01,1000,1000,0,0.00,100.00
1090529,708547,世禾永豐97購01,1000,1000,0,0.00,100.00
1090529,708548,尼克森永豐97購01,1000,1000,0,0.00,100.00
1090529,708549,立敦永豐97購01,1000,1000,0,0.00,100.00
1090529,708550,同亨永豐97購01,4000,4000,0,0.00,100.00
1090529,708551,直得永豐97購01,500,500,0,0.00,100.00
1090529,708552,南光永豐97購01,1500,1500,0,0.00,100.00
1090529,708553,威剛永豐98購01,1000,1000,0,0.00,100.00
1090529,708554,幃翔永豐97購01,1500,1500,0,0.00,100.00
1090529,708555,新潤永豐97購01,2000,2000,0,0.00,100.00
1090529,708556,網龍永豐97購01,2000,2000,0,0.00,100.00
1090529,708557,緯軟永豐97購01,500,500,0,0.00,100.00
1090529,708558,環球晶永豐97購01,1000,1000,0,0.00,100.00
1090529,708559,聯上永豐97購01,1500,1500,0,0.00,100.00
1090529,708560,大中康和97購01,5000,5000,0,0.00,100.00
1090529,708561,亞泰康和97購01,5000,5000,0,0.00,100.00
1090529,708562,博智康和97購01,1000,1000,0,0.00,100.00
1090529,708563,力致元富97購01,5000,5000,0,0.00,100.00
1090529,708564,中菲行元富97購01,2000,2000,0,0.00,100.00
1090529,708565,太景*元富97購01,3500,3500,0,0.00,100.00
1090529,708566,世禾元富97購01,2000,2000,0,0.00,100.00
1090529,708567,尼克森元富97購01,2000,2000,0,0.00,100.00
1090529,708568,幃翔元富97購01,2500,2500,0,0.00,100.00
1090529,708569,力致統一97購01,5000,5000,0,0.00,100.00
1090529,708570,力致統一97購02,5000,5000,0,0.00,100.00
1090529,708571,環球晶統一97購01,5000,5000,0,0.00,100.00
1090529,708572,兆利凱基98購02,500,500,0,0.00,100.00
1090529,708574,威剛凱基99購01,814,814,0,0.00,100.00
1090529,708575,精測凱基98購01,5500,5500,0,0.00,100.00
1090529,708576,聯亞凱基99購01,555,555,0,0.00,100.00
1090529,708577,頎邦凱基97購03,5500,5500,0,0.00,100.00
1090529,708578,中美晶麥證97購01,10000,10000,0,0.00,100.00
1090529,708579,原相麥證97購01,1000,1000,0,0.00,100.00
1090529,708580,神盾元富97購01,5000,5000,0,0.00,100.00
1090529,708581,神盾元富97購02,1000,1000,0,0.00,100.00
1090529,708582,宇峻元大97購04,500,500,0,0.00,100.00
1090529,708583,亞泰元大97購01,8000,8000,0,0.00,100.00
1090529,708584,威剛元大98購02,2000,2000,0,0.00,100.00
1090529,708585,建榮元大97購02,2000,2000,0,0.00,100.00
1090529,708586,原相元大98購01,500,500,0,0.00,100.00
1090529,708587,原相元大99購01,500,500,0,0.00,100.00
1090529,708588,群聯元大98購01,632,632,0,0.00,100.00
1090529,708589,聯亞元大98購01,500,500,0,0.00,100.00
1090529,708590,雙美元大99購01,1000,1000,0,0.00,100.00
1090529,708591,雙鴻元大99購03,1200,1500,-300,-20.00,100.00
1090529,708592,穩懋元大97購03,500,500,0,0.00,100.00
1090529,708593,穩懋元大97購04,1000,1000,0,0.00,100.00
1090529,708594,鈊象元大99購01,629,629,0,0.00,100.00
1090529,708595,大江兆豐97購02,1000,1000,0,0.00,100.00
1090529,708596,群聯兆豐98購01,5000,5000,0,0.00,100.00
1090529,708597,迅得康和97購01,5000,5000,0,0.00,100.00
1090529,708598,六角群益98購02,1800,1800,0,0.00,100.00
1090529,708599,亞泰群益97購01,1600,1600,0,0.00,100.00
1090529,708600,台燿亞東97購01,1300,1300,0,0.00,100.00
1090529,708601,光頡永豐97購01,500,500,0,0.00,100.00
1090529,708602,亞泰永豐97購01,1000,1000,0,0.00,100.00
1090529,708603,力致元富97購02,5000,5000,0,0.00,100.00
1090529,708604,鈺太元富97購01,1000,1000,0,0.00,100.00
1090529,708605,久元台新97購01,1000,5000,-4000,-80.00,100.00
1090529,708606,大中台新97購01,5000,5000,0,0.00,100.00
1090529,708607,晶焱台新97購01,5000,5000,0,0.00,100.00
1090529,708608,光頡統一97購01,5000,5000,0,0.00,100.00
1090529,708609,光頡統一99購01,5000,5000,0,0.00,100.00
1090529,708610,合晶統一97購01,5000,5000,0,0.00,100.00
1090529,708611,大中中信99購01,10000,10000,0,0.00,100.00
1090529,708612,亞泰中信97購01,10000,10000,0,0.00,100.00
1090529,708613,博智中信99購01,5000,5000,0,0.00,100.00
1090529,708614,緯軟中信97購01,5000,5000,0,0.00,100.00
1090529,708615,台半凱基98購01,500,500,0,0.00,100.00
1090529,708616,兆利凱基98購03,500,500,0,0.00,100.00
1090529,708617,宇峻凱基99購01,500,500,0,0.00,100.00
1090529,708618,新普凱基98購01,500,500,0,0.00,100.00
1090529,708619,璟德凱基98購01,5835,835,5000,598.80,100.00
1090529,708620,環球晶凱基97購02,500,500,0,0.00,100.00
1090529,708621,頎邦第一97購01,5000,5000,0,0.00,100.00
1090529,708622,光頡永豐97購02,1000,1000,0,0.00,100.00
1090529,708623,建榮永豐98購01,1000,1000,0,0.00,100.00
1090529,708624,雙美永豐98購01,500,500,0,0.00,100.00
1090529,708625,雙鴻永豐98購01,4000,4000,0,0.00,100.00
1090529,708626,亞泰國票97購01,1000,1000,0,0.00,100.00
1090529,708627,新普國票98購01,500,500,0,0.00,100.00
1090529,708628,廣明國票98購01,1000,1000,0,0.00,100.00
1090529,708629,璟德國票98購01,800,800,0,0.00,100.00
1090529,708630,環宇國票98購01,500,500,0,0.00,100.00
1090529,708631,頎邦國票98購01,1000,1000,0,0.00,100.00
1090529,708632,M31元大98購01,1000,1000,0,0.00,100.00
1090529,708634,信昌電元大98購02,500,500,0,0.00,100.00
1090529,708635,建榮元大97購03,2000,2000,0,0.00,100.00
1090529,708636,原相元大98購02,500,500,0,0.00,100.00
1090529,708637,群聯元大98購02,594,594,0,0.00,100.00
1090529,708638,精測元大97購04,500,500,0,0.00,100.00
1090529,708639,網龍元大97購01,1300,1500,-200,-13.33,100.00
1090529,708640,璟德元大97購03,5000,5000,0,0.00,100.00
1090529,708641,鈊象元大98購02,500,500,0,0.00,100.00
1090529,708642,頎邦元大97購03,8000,8000,0,0.00,100.00
1090529,708643,頎邦元大97購04,1500,1500,0,0.00,100.00
1090529,708644,雙美國泰99購01,1200,1200,0,0.00,100.00
1090529,708645,聯亞兆豐98購01,5000,5000,0,0.00,100.00
1090529,708646,櫃200兆豐97購01,5000,5000,0,0.00,100.00
1090529,708647,泰博群益97購01,500,500,0,0.00,100.00
1090529,708648,VHQ中信97購01,5000,5000,0,0.00,100.00
1090529,708649,鈊象中信97購01,1000,1000,0,0.00,100.00
1090529,708650,迅得麥證98購01,5000,5000,0,0.00,100.00
1090529,708651,大學光元富99購01,5000,5000,0,0.00,100.00
1090529,708652,光頡元富97購01,2000,2000,0,0.00,100.00
1090529,708653,神盾元富97購03,1000,1000,0,0.00,100.00
1090529,708654,力致統一97購03,5000,5000,0,0.00,100.00
1090529,708655,波若威統一99購01,5000,5000,0,0.00,100.00
1090529,708656,信昌電統一98購01,5000,5000,0,0.00,100.00
1090529,708657,兆利台新97購01,5000,5000,0,0.00,100.00
1090529,708658,神盾台新98購01,5000,5000,0,0.00,100.00
1090529,708659,合晶凱基97購03,500,500,0,0.00,100.00
1090529,708660,宇峻凱基99購02,500,500,0,0.00,100.00
1090529,708661,良維凱基97購03,994,994,0,0.00,100.00
1090529,708662,信昌電凱基98購02,500,500,0,0.00,100.00
1090529,708663,茂達凱基97購01,500,500,0,0.00,100.00
1090529,708664,群聯凱基98購02,1110,1110,0,0.00,100.00
1090529,708665,網家凱基97購01,500,500,0,0.00,100.00
1090529,708666,聚積凱基97購01,500,500,0,0.00,100.00
1090529,708667,廣明凱基98購02,856,856,0,0.00,100.00
1090529,708668,優群凱基98購03,500,500,0,0.00,100.00
1090529,708669,聯亞凱基99購02,500,500,0,0.00,100.00
1090529,708670,鈺太凱基98購01,500,500,0,0.00,100.00
1090529,708671,頎邦凱基97購04,500,500,0,0.00,100.00
1090529,708672,M31元大99購01,1000,1000,0,0.00,100.00
1090529,708673,凡甲元大98購02,1500,1500,0,0.00,100.00
1090529,708674,大宇資元大98購01,1000,1000,0,0.00,100.00
1090529,708675,六角元大98購02,500,500,0,0.00,100.00
1090529,708677,晶焱元大98購01,1000,1000,0,0.00,100.00
1090529,708678,鈊象元大97購04,800,800,0,0.00,100.00
1090529,708679,光頡國票98購01,1500,1500,0,0.00,100.00
1090529,708680,金居國票98購01,500,500,0,0.00,100.00
1090529,708681,建榮國票99購01,1000,1000,0,0.00,100.00
1090529,708682,穩懋國票98購01,500,500,0,0.00,100.00
1090529,708683,鈊象國票97購03,500,500,0,0.00,100.00
1090529,708684,光頡國泰98購01,500,500,0,0.00,100.00
1090529,708685,亞泰國泰98購01,1000,1000,0,0.00,100.00
1090529,708686,世界兆豐97購01,5000,5000,0,0.00,100.00
1090529,708687,同致兆豐98購01,5000,5000,0,0.00,100.00
1090529,708688,宜鼎兆豐98購01,5000,5000,0,0.00,100.00
1090529,708689,勝麗群益98購02,1750,1750,0,0.00,100.00
1090529,708690,晟德群益97購01,5000,5000,0,0.00,100.00
1090529,708691,穩懋永豐97購02,1500,1500,0,0.00,100.00
1090529,708692,元太亞東97購01,1300,1300,0,0.00,100.00
1090529,708693,台半中信99購01,5000,5000,0,0.00,100.00
1090529,708694,M31統一98購01,5000,5000,0,0.00,100.00
1090529,708695,波若威統一97購01,5000,5000,0,0.00,100.00
1090529,708696,建榮統一9A購01,5000,5000,0,0.00,100.00
1090529,708697,建榮統一9A購02,5000,5000,0,0.00,100.00
1090529,708698,雙鴻統一97購02,5000,5000,0,0.00,100.00
1090529,708699,雙鴻統一99購01,5000,5000,0,0.00,100.00
1090529,708700,穩懋統一99購01,5000,5000,0,0.00,100.00
1090529,708701,建榮凱基97購02,675,675,0,0.00,100.00
1090529,708702,原相凱基98購02,500,500,0,0.00,100.00
1090529,708703,精測凱基97購04,500,500,0,0.00,100.00
1090529,708704,環球晶凱基97購03,620,620,0,0.00,100.00
1090529,708705,穩懋凱基97購01,500,500,0,0.00,100.00
1090529,708706,鈺太凱基98購02,500,500,0,0.00,100.00
1090529,708707,大江元大97購04,1100,1500,-400,-26.66,100.00
1090529,708708,光頡元大98購01,500,500,0,0.00,100.00
1090529,708709,新普元大97購02,1000,1000,0,0.00,100.00
1090529,708710,新普元大97購03,5000,5000,0,0.00,100.00
1090529,708711,群聯元大97購05,823,823,0,0.00,100.00
1090529,708712,聯亞元大97購05,500,500,0,0.00,100.00
1090529,708713,雙鴻元大99購04,2000,2000,0,0.00,100.00
1090529,708714,聯亞元富97購01,1000,1000,0,0.00,100.00
1090529,708715,台燿日盛97購01,10000,10000,0,0.00,100.00
1090529,708716,建榮永豐97購02,3000,3000,0,0.00,100.00
1090529,708717,閎康永豐97購01,1000,1000,0,0.00,100.00
1090529,708718,譜瑞永豐97購01,500,1000,-500,-50.00,100.00
1090529,708719,鈊象永豐98購01,500,500,0,0.00,100.00
1090529,708720,力致國票97購01,2000,2000,0,0.00,100.00
1090529,708721,光頡國票98購02,2000,2000,0,0.00,100.00
1090529,708722,金居國票98購02,500,500,0,0.00,100.00
1090529,708723,威剛國票98購02,500,500,0,0.00,100.00
1090529,708724,晶焱國票98購01,1000,1000,0,0.00,100.00
1090529,708725,群聯國票98購02,500,500,0,0.00,100.00
1090529,708726,廣明國票98購02,600,800,-200,-25.00,100.00
1090529,708727,光頡國泰99購01,500,500,0,0.00,100.00
1090529,708728,原相國泰98購03,1162,1162,0,0.00,100.00
1090529,708729,大江富邦99購01,10000,10000,0,0.00,100.00
1090529,708730,久元群益97購01,500,500,0,0.00,100.00
1090529,708731,聚積群益97購02,1000,1000,0,0.00,100.00
1090529,708732,頎邦群益98購02,500,500,0,0.00,100.00
1090529,708733,M31凱基99購01,500,500,0,0.00,100.00
1090529,708734,中美晶凱基97購04,500,500,0,0.00,100.00
1090529,708735,昇達科凱基97購01,500,500,0,0.00,100.00
1090529,708736,聯亞凱基97購02,500,500,0,0.00,100.00
1090529,708737,雙美凱基99購01,578,578,0,0.00,100.00
1090529,708738,穩懋凱基97購02,500,500,0,0.00,100.00
1090529,708739,穩懋凱基97購03,500,500,0,0.00,100.00
1090529,708740,譜瑞凱基97購01,500,500,0,0.00,100.00
1090529,708741,鈊象凱基98購03,500,500,0,0.00,100.00
1090529,708742,新普麥證97購01,10000,10000,0,0.00,100.00
1090529,708743,同致元富97購01,1000,1000,0,0.00,100.00
1090529,708744,金居元富97購01,1000,1000,0,0.00,100.00
1090529,708745,原相元富97購01,500,500,0,0.00,100.00
1090529,708746,穩懋元富97購01,2500,2500,0,0.00,100.00
1090529,708747,立端亞東98購01,1200,1200,0,0.00,100.00
1090529,708748,合晶永豐97購03,1200,1200,0,0.00,100.00
1090529,708749,旺矽永豐97購03,500,500,0,0.00,100.00
1090529,708750,信驊永豐97購01,500,2000,-1500,-75.00,100.00
1090529,708751,聯亞永豐97購01,1000,1000,0,0.00,100.00
1090529,708752,原相統一97購01,1000,1000,0,0.00,100.00
1090529,708753,廣明統一9A購01,5000,5000,0,0.00,100.00
1090529,708754,聯亞統一98購01,5000,5000,0,0.00,100.00
1090529,708755,鈊象統一99購01,5000,5000,0,0.00,100.00
1090529,708756,大中國票98購01,1500,1500,0,0.00,100.00
1090529,708757,大江國票97購06,4884,4884,0,0.00,100.00
1090529,708758,佳邦國票98購01,1000,1000,0,0.00,100.00
1090529,708759,宜鼎國票97購04,500,500,0,0.00,100.00
1090529,708760,信昌電國票98購02,1000,1000,0,0.00,100.00
1090529,708761,宣德國票98購01,3000,4000,-1000,-25.00,100.00
1090529,708762,神盾國票98購02,4000,4000,0,0.00,100.00
1090529,708763,群聯國票98購03,1280,1280,0,0.00,100.00
1090529,708764,緯軟國票98購01,1000,1000,0,0.00,100.00
1090529,708765,威剛國泰98購03,500,500,0,0.00,100.00
1090529,708766,廣明國泰98購01,1500,1500,0,0.00,100.00
1090529,708767,穩懋富邦99購01,15000,15000,0,0.00,100.00
1090529,708768,六角元大97購01,500,500,0,0.00,100.00
1090529,708769,合晶元大98購03,1000,1000,0,0.00,100.00
1090529,708770,泰博元大97購01,1000,1000,0,0.00,100.00
1090529,708771,精測元大97購05,1000,1000,0,0.00,100.00
1090529,708772,聚積元大98購01,10000,10000,0,0.00,100.00
1090529,708773,廣明元大97購02,1000,1000,0,0.00,100.00
1090529,708774,璟德元大97購04,2000,2000,0,0.00,100.00
1090529,708775,穩懋元大97購07,1000,1000,0,0.00,100.00
1090529,708776,穩懋元大98購01,1555,1555,0,0.00,100.00
1090529,708777,旺矽兆豐98購01,5000,5000,0,0.00,100.00
1090529,708778,環球晶兆豐98購01,5000,5000,0,0.00,100.00
1090529,708779,雙鴻兆豐98購01,5000,5000,0,0.00,100.00
1090529,708780,穩懋兆豐97購03,5000,5000,0,0.00,100.00
1090529,708781,信驊群益97購01,1100,1100,0,0.00,100.00
1090529,708782,建榮群益98購01,2000,2000,0,0.00,100.00
1090529,708783,優群群益99購01,1000,1000,0,0.00,100.00
1090529,708784,環宇群益97購02,1600,1600,0,0.00,100.00
1090529,708785,信驊中信9B購01,10000,10000,0,0.00,100.00
1090529,708786,中美晶凱基97購05,500,500,0,0.00,100.00
1090529,708787,同致凱基98購02,644,644,0,0.00,100.00
1090529,708788,泰博凱基99購01,500,500,0,0.00,100.00
1090529,708789,群聯凱基97購01,500,500,0,0.00,100.00
1090529,708790,優群凱基98購04,500,500,0,0.00,100.00
1090529,708791,雙美凱基99購02,500,500,0,0.00,100.00
1090529,708792,凡甲國票98購01,1000,1000,0,0.00,100.00
1090529,708793,迅得國票98購01,2500,2500,0,0.00,100.00
1090529,708794,旺矽國票98購01,500,500,0,0.00,100.00
1090529,708795,原相國票98購03,1000,1000,0,0.00,100.00
1090529,708796,兆利群益97購01,1400,1400,0,0.00,100.00
1090529,708797,金居群益99購01,2500,2500,0,0.00,100.00
1090529,708798,晶焱群益99購01,2000,2000,0,0.00,100.00
1090529,708799,閎康群益97購02,2300,2300,0,0.00,100.00
1090529,708800,凡甲元富99購01,5000,5000,0,0.00,100.00
1090529,708801,六角元富97購01,5000,5000,0,0.00,100.00
1090529,708802,欣銓元富97購01,1000,1000,0,0.00,100.00
1090529,708803,晶焱元富99購01,5000,5000,0,0.00,100.00
1090529,708804,廣明元富99購01,5000,5000,0,0.00,100.00
1090529,708805,環球晶元富98購01,2400,2400,0,0.00,100.00
1090529,708806,環球晶元富99購01,3400,3400,0,0.00,100.00
1090529,708807,雙美元富97購01,5000,5000,0,0.00,100.00
1090529,708808,雙鴻元富97購01,5000,5000,0,0.00,100.00
1090529,708809,穩懋元富97購02,2500,2500,0,0.00,100.00
1090529,708810,鈊象元富97購01,5000,5000,0,0.00,100.00
1090529,708811,雙鴻國泰98購01,1100,1100,0,0.00,100.00
1090529,708812,精測台新98購01,5000,5000,0,0.00,100.00
1090529,708813,宇峻元大98購01,665,665,0,0.00,100.00
1090529,708814,建榮元大97購04,2500,2500,0,0.00,100.00
1090529,708815,泰博元大97購02,1000,1000,0,0.00,100.00
1090529,708816,聯亞元大97購06,1000,1000,0,0.00,100.00
1090529,708817,譜瑞元大98購01,500,500,0,0.00,100.00
1090529,708818,鈊象元大98購03,1100,1100,0,0.00,100.00
1090529,708819,合晶永豐97購04,1000,1000,0,0.00,100.00
1090529,708820,威剛永豐99購01,1000,1000,0,0.00,100.00
1090529,708821,原相永豐97購02,2500,2500,0,0.00,100.00
1090529,708822,泰博永豐97購01,500,500,0,0.00,100.00
1090529,708823,勝麗永豐97購01,1000,1000,0,0.00,100.00
1090529,708824,廣明永豐97購03,1000,1000,0,0.00,100.00
1090529,708825,碩禾中信9A購01,5000,5000,0,0.00,100.00
1090529,708826,威剛統一9A購01,5000,5000,0,0.00,100.00
1090529,708827,群聯統一97購02,1000,1000,0,0.00,100.00
1090529,708828,六角凱基99購01,500,500,0,0.00,100.00
1090529,708829,宜鼎凱基98購01,500,500,0,0.00,100.00
1090529,708830,信昌電凱基97購03,500,500,0,0.00,100.00
1090529,708831,廣明凱基99購01,500,500,0,0.00,100.00
1090529,708832,群聯台新97購04,500,500,0,0.00,100.00
1090529,708833,中美晶元大97購05,5000,5000,0,0.00,100.00
1090529,708834,中美晶元大97購06,1000,1000,0,0.00,100.00
1090529,708836,宣德元大97購02,651,651,0,0.00,100.00
1090529,708837,新普元大97購04,5000,5000,0,0.00,100.00
1090529,708838,新普元大97購05,5000,5000,0,0.00,100.00
1090529,708839,群聯元大97購06,1200,1200,0,0.00,100.00
1090529,708840,雍智元大99購01,1500,1500,0,0.00,100.00
1090529,708841,網龍元大98購01,500,1500,-1000,-66.66,100.00
1090529,708842,環球晶元大97購04,5000,5000,0,0.00,100.00
1090529,708843,環球晶元大97購05,5000,5000,0,0.00,100.00
1090529,708844,聯亞元大97購07,1000,1000,0,0.00,100.00
1090529,708845,雙鴻元大97購03,5000,5000,0,0.00,100.00
1090529,708846,鈊象元大98購04,2372,2372,0,0.00,100.00
1090529,708847,群聯第一97購01,1000,1000,0,0.00,100.00
1090529,708848,中美晶永豐97購01,1000,1000,0,0.00,100.00
1090529,708849,胡連永豐97購01,1000,1000,0,0.00,100.00
1090529,708850,閎康永豐97購02,1000,1000,0,0.00,100.00
1090529,708851,精測永豐97購02,1000,1000,0,0.00,100.00
1090529,708852,鈊象永豐97購02,1200,1200,0,0.00,100.00
1090529,708853,世界群益98購04,3000,3000,0,0.00,100.00
1090529,708854,晶焱群益99購02,1000,1000,0,0.00,100.00
1090529,708855,大江元富97購01,5000,5000,0,0.00,100.00
1090529,708856,台燿元富97購01,2500,2500,0,0.00,100.00
1090529,708857,宜鼎元富97購01,5000,5000,0,0.00,100.00
1090529,708858,昇達科元富97購01,1000,1000,0,0.00,100.00
1090529,708859,信驊元富97購01,2500,2500,0,0.00,100.00
1090529,708860,威剛元富97購02,5000,5000,0,0.00,100.00
1090529,708861,新普元富97購01,2000,2000,0,0.00,100.00
1090529,708862,網家元富97購01,1000,1000,0,0.00,100.00
1090529,708863,聚積元富97購01,5000,5000,0,0.00,100.00
1090529,708864,穩懋元富97購03,2500,2500,0,0.00,100.00
1090529,708865,直得國票97購01,1500,1500,0,0.00,100.00
1090529,708866,原相國泰98購04,2500,2500,0,0.00,100.00
1090529,708867,鈊象國泰99購01,500,500,0,0.00,100.00
1090529,708868,鈊象中信99購01,5000,5000,0,0.00,100.00
1090529,708869,凡甲凱基98購01,500,500,0,0.00,100.00
1090529,708870,大江凱基98購03,504,504,0,0.00,100.00
1090529,708871,信驊凱基98購01,500,500,0,0.00,100.00
1090529,708872,新鉅科凱基97購01,500,500,0,0.00,100.00
1090529,708873,精測凱基98購02,500,500,0,0.00,100.00
1090529,708874,群聯統一97購03,1000,1000,0,0.00,100.00
1090529,708875,譜瑞統一97購01,5000,5000,0,0.00,100.00
1090529,708876,信昌電兆豐98購01,5000,5000,0,0.00,100.00
1090529,708877,胡連康和97購01,5000,5000,0,0.00,100.00
1090529,708878,台燿群益97購01,1300,1300,0,0.00,100.00
1090529,708879,博智群益97購01,500,500,0,0.00,100.00
1090529,708880,雙鴻群益99購01,500,500,0,0.00,100.00
1090529,708881,金居國泰99購01,2000,2000,0,0.00,100.00
1090529,708882,威剛元富97購04,1000,1000,0,0.00,100.00
1090529,708883,原相元富97購02,5000,5000,0,0.00,100.00
1090529,708884,聯亞元富97購03,1000,1000,0,0.00,100.00
1090529,708885,穩懋元富97購04,3500,3500,0,0.00,100.00
1090529,708886,鈊象元富97購02,5000,5000,0,0.00,100.00
1090529,708887,鈊象台新97購02,1000,1000,0,0.00,100.00
1090529,708888,中美晶元大97購07,5000,5000,0,0.00,100.00
1090529,708889,台燿元大97購01,12000,12000,0,0.00,100.00
1090529,708890,宜鼎元大97購02,1000,1000,0,0.00,100.00
1090529,708891,金居元大99購01,1000,1000,0,0.00,100.00
1090529,708892,胡連元大97購01,9000,9000,0,0.00,100.00
1090529,708893,泰博元大97購03,800,800,0,0.00,100.00
1090529,708894,閎康元大97購01,500,500,0,0.00,100.00
1090529,708895,環球晶元大97購06,500,500,0,0.00,100.00
1090529,708896,環球晶元大97購07,500,500,0,0.00,100.00
1090529,708897,櫃200元大99購03,1000,1000,0,0.00,100.00
1090529,708898,櫃200元大99購04,1000,1000,0,0.00,100.00
1090529,708899,頎邦元大97購05,5000,5000,0,0.00,100.00
1090529,708900,中美晶元大97購08,5000,5000,0,0.00,100.00
1090529,708901,台燿元大97購02,1500,1500,0,0.00,100.00
1090529,708902,迅得元大99購01,1000,1000,0,0.00,100.00
1090529,708903,宜鼎元大97購03,500,500,0,0.00,100.00
1090529,708904,旺矽元大98購01,1000,1000,0,0.00,100.00
1090529,708905,威剛元大97購01,500,500,0,0.00,100.00
1090529,708906,泰博元大97購04,1000,2500,-1500,-60.00,100.00
1090529,708907,精測元大97購06,1500,1500,0,0.00,100.00
1090529,708908,廣明元大97購03,1000,1000,0,0.00,100.00
1090529,708909,優群元大99購01,1000,1000,0,0.00,100.00
1090529,708910,環球晶元大97購08,5000,5000,0,0.00,100.00
1090529,708911,環球晶元大97購09,500,500,0,0.00,100.00
1090529,708912,世界麥證97購02,10000,10000,0,0.00,100.00
1090529,708913,大江永豐97購03,1000,1000,0,0.00,100.00
1090529,708914,旺矽永豐97購04,500,500,0,0.00,100.00
1090529,708915,新普永豐97購01,1000,1000,0,0.00,100.00
1090529,708916,精華永豐97購01,500,500,0,0.00,100.00
1090529,708917,原相兆豐98購01,5000,5000,0,0.00,100.00
1090529,708918,群聯台新97購05,1000,1000,0,0.00,100.00
1090529,708919,中美晶群益97購04,500,500,0,0.00,100.00
1090529,708920,同致群益97購01,5000,5000,0,0.00,100.00
1090529,708921,勝麗群益97購01,1550,1550,0,0.00,100.00
1090529,708922,緯軟群益98購02,2500,2500,0,0.00,100.00
1090529,708923,鈊象群益97購01,500,500,0,0.00,100.00
1090529,708924,穩懋永昌9C購01,1021,1021,0,0.00,100.00
1090529,708925,世界統一97購02,5000,5000,0,0.00,100.00
1090529,708926,胡連統一98購01,5000,5000,0,0.00,100.00
1090529,708927,胡連統一99購01,5000,5000,0,0.00,100.00
1090529,708928,環球晶統一97購02,5000,5000,0,0.00,100.00
1090529,708929,雍智中信97購01,1500,5000,-3500,-70.00,100.00
1090529,708930,聚積中信97購01,2000,2000,0,0.00,100.00
1090529,708931,VHQ凱基97購01,500,500,0,0.00,100.00
1090529,708932,VHQ凱基98購01,1113,1113,0,0.00,100.00
1090529,708933,神盾凱基98購02,500,500,0,0.00,100.00
1090529,708934,晶焱凱基98購02,500,500,0,0.00,100.00
1090529,708935,環球晶凱基97購04,500,500,0,0.00,100.00
1090529,708936,環球晶凱基97購05,1900,1900,0,0.00,100.00
1090529,708937,雙鴻富邦98購01,5000,5000,0,0.00,100.00
1090529,708938,大宇資國票98購01,5000,5000,0,0.00,100.00
1090529,708939,金居國票98購03,500,500,0,0.00,100.00
1090529,708940,碩禾國票98購01,4000,4000,0,0.00,100.00
1090529,708941,M31元富97購01,3500,3500,0,0.00,100.00
1090529,708942,金居第一97購01,5000,5000,0,0.00,100.00
1090529,708943,M31元富97購02,3500,3500,0,0.00,100.00
1090529,708944,閎康元富97購01,3000,3000,0,0.00,100.00
1090529,708945,大田永豐97購01,1000,1000,0,0.00,100.00
1090529,708946,六角永豐97購02,1000,1000,0,0.00,100.00
1090529,708947,群聯永豐97購01,1500,1500,0,0.00,100.00
1090529,708948,雙鴻永豐97購04,4000,4000,0,0.00,100.00
1090529,708949,旺矽康和97購02,5000,5000,0,0.00,100.00
1090529,708950,威剛康和97購02,5000,5000,0,0.00,100.00
1090529,708951,合晶群益99購01,1550,1550,0,0.00,100.00
1090529,708952,迅得群益98購01,5000,5000,0,0.00,100.00
1090529,708953,宜鼎群益97購02,500,500,0,0.00,100.00
1090529,708954,胡連群益97購01,1600,1600,0,0.00,100.00
1090529,708955,雙美群益98購01,500,500,0,0.00,100.00
1090529,708956,大江凱基97購02,1611,1611,0,0.00,100.00
1090529,708957,世界凱基97購01,500,500,0,0.00,100.00
1090529,708958,台燿凱基98購01,500,500,0,0.00,100.00
1090529,708959,宣德凱基98購01,500,500,0,0.00,100.00
1090529,708960,璟德凱基97購01,500,500,0,0.00,100.00
1090529,708961,環球晶凱基97購06,500,500,0,0.00,100.00
1090529,708962,鈊象凱基98購04,500,500,0,0.00,100.00
1090529,708963,譜瑞凱基97購02,500,500,0,0.00,100.00
1090529,708964,信昌電國票98購03,1000,1000,0,0.00,100.00
1090529,708965,廣明國票98購03,800,800,0,0.00,100.00
1090529,708966,聯亞國票98購01,5500,6000,-500,-8.33,100.00
1090529,708967,大江元大97購05,8000,8000,0,0.00,100.00
1090529,708968,中美晶元大97購09,1500,1500,0,0.00,100.00
1090529,708969,宣德元大97購03,566,766,-200,-26.10,100.00
1090529,708970,群聯元大97購07,500,500,0,0.00,100.00
1090529,708971,精測元大97購07,500,500,0,0.00,100.00
1090529,708972,網龍元大98購02,500,1500,-1000,-66.66,100.00
1090529,708973,聚積元大97購01,1000,1000,0,0.00,100.00
1090529,708974,環球晶元大97購10,800,800,0,0.00,100.00
1090529,708975,環球晶元大97購11,500,500,0,0.00,100.00
1090529,708976,環球晶元大97購12,800,800,0,0.00,100.00
1090529,708977,M31兆豐97購01,5000,5000,0,0.00,100.00
1090529,708978,頎邦兆豐97購01,5000,5000,0,0.00,100.00
1090529,708979,VHQ統一98購01,5000,5000,0,0.00,100.00
1090529,708980,威剛統一98購01,5000,5000,0,0.00,100.00
1090529,708981,光頡國票98購03,3000,3000,0,0.00,100.00
1090529,708982,大學光國泰99購01,1000,1000,0,0.00,100.00
1090529,708983,穩懋國泰98購02,700,700,0,0.00,100.00
1090529,708984,大江凱基97購03,500,500,0,0.00,100.00
1090529,708985,六角凱基99購02,500,500,0,0.00,100.00
1090529,708986,旺矽凱基97購02,5500,5500,0,0.00,100.00
1090529,708987,環球晶凱基97購07,500,500,0,0.00,100.00
1090529,708988,雙鴻凱基98購02,500,500,0,0.00,100.00
1090529,708989,穩懋凱基97購05,500,500,0,0.00,100.00
1090529,708990,穩懋凱基98購01,500,500,0,0.00,100.00
1090529,708991,穩懋凱基98購02,500,500,0,0.00,100.00
1090529,708992,M31元大98購02,1000,1000,0,0.00,100.00
1090529,708993,大學光元大98購01,500,500,0,0.00,100.00
1090529,708994,中美晶元大98購01,1010,1010,0,0.00,100.00
1090529,708995,世界元大97購01,1500,1500,0,0.00,100.00
1090529,708996,保瑞元大97購01,6000,6000,0,0.00,100.00
1090529,708997,晶焱元大99購01,1000,1000,0,0.00,100.00
1090529,708998,大學光康和9B購01,5000,5000,0,0.00,100.00
1090529,708999,泰博群益97購02,5000,5000,0,0.00,100.00
1090529,709000,環球晶群益98購01,1850,1850,0,0.00,100.00
1090529,709001,鈺太群益97購01,2000,2000,0,0.00,100.00
1090529,709002,環球晶日盛97購01,10000,10000,0,0.00,100.00
1090529,709003,世禾永豐97購02,1000,1000,0,0.00,100.00
1090529,709004,順達永豐97購01,1000,1000,0,0.00,100.00
1090529,709005,新揚科永豐97購01,2000,2000,0,0.00,100.00
1090529,709006,穩懋永豐97購03,1500,1500,0,0.00,100.00
1090529,709007,勝麗台新97購01,5000,5000,0,0.00,100.00
1090529,709008,中美晶元富99購01,5000,5000,0,0.00,100.00
1090529,709009,信昌電元富97購02,3000,3000,0,0.00,100.00
1090529,709010,宣德元富97購01,5000,5000,0,0.00,100.00
1090529,709011,緯軟元富97購01,5000,5000,0,0.00,100.00
1090529,709012,環球晶元富97購03,500,500,0,0.00,100.00
1090529,709013,環球晶元富97購04,5000,5000,0,0.00,100.00
1090529,709014,鈊象元富97購04,3500,3500,0,0.00,100.00
1090529,709015,世禾統一99購01,5000,5000,0,0.00,100.00
1090529,709016,世禾統一9A購01,5000,5000,0,0.00,100.00
1090529,709017,金居統一98購01,5000,5000,0,0.00,100.00
1090529,709018,順達統一99購01,5000,5000,0,0.00,100.00
1090529,709019,中美晶凱基9A購01,500,500,0,0.00,100.00
1090529,709020,迅得凱基9A購01,2051,2051,0,0.00,100.00
1090529,709021,亞泰凱基9A購01,500,500,0,0.00,100.00
1090529,709022,保瑞凱基98購01,500,500,0,0.00,100.00
1090529,709023,新普凱基98購02,1325,1325,0,0.00,100.00
1090529,709024,環球晶凱基98購01,500,500,0,0.00,100.00
1090529,709025,環球晶凱基99購01,572,572,0,0.00,100.00
1090529,709026,穩懋日盛98購01,10000,10000,0,0.00,100.00
1090529,709027,大江國票99購01,500,500,0,0.00,100.00
1090529,709028,凡甲富邦9A購01,7000,7000,0,0.00,100.00
1090529,709029,聯亞富邦9A購01,9000,9000,0,0.00,100.00
1090529,709030,大江元大98購01,5000,5000,0,0.00,100.00
1090529,709031,群聯元大99購01,500,500,0,0.00,100.00
1090529,709032,碩禾元大99購01,1000,1000,0,0.00,100.00
1090529,709033,優群元大99購02,500,500,0,0.00,100.00
1090529,709034,環球晶元大98購01,8000,8000,0,0.00,100.00
1090529,709035,環球晶元大98購02,5000,5000,0,0.00,100.00
1090529,709036,環球晶元大98購03,8000,8000,0,0.00,100.00
1090529,709037,聯亞元大99購01,1500,1500,0,0.00,100.00
1090529,709038,譜瑞元大98購02,5000,5000,0,0.00,100.00
1090529,709039,譜瑞元富98購01,3500,3500,0,0.00,100.00
1090529,709040,勝麗台新98購01,5000,5000,0,0.00,100.00
1090529,709041,精測台新99購01,5000,5000,0,0.00,100.00
1090529,709042,宣德兆豐98購01,5000,5000,0,0.00,100.00
1090529,709043,威剛群益9A購01,500,500,0,0.00,100.00
1090529,709044,統新康和98購01,5000,5000,0,0.00,100.00
1090529,709045,神盾群益9A購01,5000,5000,0,0.00,100.00
1090529,709046,廣明群益98購01,1500,1500,0,0.00,100.00
1090529,709047,世禾永豐98購01,2000,2000,0,0.00,100.00
1090529,709048,合晶永豐98購01,500,500,0,0.00,100.00
1090529,709049,亞泰永豐99購01,1500,1500,0,0.00,100.00
1090529,709050,金居永豐98購01,500,500,0,0.00,100.00
1090529,709051,統新永豐98購01,1000,1000,0,0.00,100.00
1090529,709052,鈊象永豐98購02,3000,3000,0,0.00,100.00
1090529,709053,M31元大98購03,1000,1000,0,0.00,100.00
1090529,709054,凡甲元大9A購01,1500,1500,0,0.00,100.00
1090529,709055,中美晶元大99購01,8000,8000,0,0.00,100.00
1090529,709056,群聯元大98購03,611,611,0,0.00,100.00
1090529,709057,精測元大98購02,800,800,0,0.00,100.00
1090529,709058,緯軟元大98購01,1000,1000,0,0.00,100.00
1090529,709059,鈊象元大99購02,600,600,0,0.00,100.00
1090529,709060,大江國泰9A購01,1500,1500,0,0.00,100.00
1090529,709061,台燿國泰99購01,1500,1500,0,0.00,100.00
1090529,709062,合晶國泰99購01,1000,1000,0,0.00,100.00
1090529,709063,雍智國票99購01,500,500,0,0.00,100.00
1090529,709064,網龍國票99購01,1000,1000,0,0.00,100.00
1090529,709065,雙鴻國票99購01,1000,1000,0,0.00,100.00
1090529,709066,中美晶統一98購01,5000,5000,0,0.00,100.00
1090529,709067,統新統一01購01,5000,5000,0,0.00,100.00
1090529,709068,統新統一98購01,5000,5000,0,0.00,100.00
1090529,709069,統新統一9B購01,5000,5000,0,0.00,100.00
1090529,709070,統新統一9C購01,5000,5000,0,0.00,100.00
1090529,709071,鈊象統一9A購01,5000,5000,0,0.00,100.00
1090529,709072,鈊象中信98購01,5000,5000,0,0.00,100.00
1090529,709073,大江凱基98購04,500,500,0,0.00,100.00
1090529,709074,大學光凱基9A購01,500,500,0,0.00,100.00
1090529,709075,中美晶凱基98購01,500,500,0,0.00,100.00
1090529,709076,合晶凱基98購02,500,500,0,0.00,100.00
1090529,709077,宜鼎凱基98購02,500,500,0,0.00,100.00
1090529,709078,昇達科凱基98購01,500,500,0,0.00,100.00
1090529,709079,信昌電凱基98購03,500,500,0,0.00,100.00
1090529,709080,宣德凱基98購02,500,500,0,0.00,100.00
1090529,709081,原相凱基98購03,500,500,0,0.00,100.00
1090529,709082,精測凱基98購03,500,500,0,0.00,100.00
1090529,709083,廣明凱基98購03,500,500,0,0.00,100.00
1090529,709084,優群凱基9A購01,500,500,0,0.00,100.00
1090529,709085,環球晶凱基98購02,500,500,0,0.00,100.00
1090529,709086,環球晶凱基99購02,500,500,0,0.00,100.00
1090529,709087,聯亞凱基98購02,500,500,0,0.00,100.00
1090529,709088,鈊象凱基9A購01,500,500,0,0.00,100.00
1090529,709089,統新元富98購01,5000,5000,0,0.00,100.00
1090529,709090,統新元富98購02,5000,5000,0,0.00,100.00
1090529,709091,穩懋統一98購03,5000,5000,0,0.00,100.00
1090529,709092,鈊象中信99購02,5000,5000,0,0.00,100.00
1090529,709093,VHQ元大99購01,10000,10000,0,0.00,100.00
1090529,709094,大江元大99購01,820,820,0,0.00,100.00
1090529,709095,六角元大99購01,500,500,0,0.00,100.00
1090529,709096,同致元大99購01,500,500,0,0.00,100.00
1090529,709097,建榮元大98購01,2000,2000,0,0.00,100.00
1090529,709098,原相元大9A購01,519,519,0,0.00,100.00
1090529,709099,鈊象元大99購03,1603,1603,0,0.00,100.00
1090529,709100,鈺太元大99購02,1500,1500,0,0.00,100.00
1090529,709101,泰博元富98購01,3000,3000,0,0.00,100.00
1090529,709102,三貝德群益98購01,5000,5000,0,0.00,100.00
1090529,709103,中美晶群益98購01,2300,2300,0,0.00,100.00
1090529,709104,良維群益98購01,1550,1550,0,0.00,100.00
1090529,709105,宣德群益98購01,5000,5000,0,0.00,100.00
1090529,709106,統新群益98購01,5000,5000,0,0.00,100.00
1090529,709107,晶焱群益98購02,1000,1000,0,0.00,100.00
1090529,709108,金居國票99購01,6000,6000,0,0.00,100.00
1090529,709109,統新國票98購01,1500,1500,0,0.00,100.00
1090529,709110,聯亞國票99購01,2000,2500,-500,-20.00,100.00
1090529,709111,VHQ永豐98購01,2000,2000,0,0.00,100.00
1090529,709112,大宇資永豐98購01,1000,1000,0,0.00,100.00
1090529,709113,大學光永豐9A購01,2000,2000,0,0.00,100.00
1090529,709114,波若威永豐99購01,1500,1500,0,0.00,100.00
1090529,709115,金可永豐98購01,1000,1000,0,0.00,100.00
1090529,709116,環球晶永豐98購01,1000,1000,0,0.00,100.00
1090529,709117,大江凱基98購05,500,500,0,0.00,100.00
1090529,709118,元太凱基98購01,500,500,0,0.00,100.00
1090529,709119,台燿凱基98購02,500,500,0,0.00,100.00
1090529,709120,同致凱基98購03,500,500,0,0.00,100.00
1090529,709121,合晶凱基98購03,500,500,0,0.00,100.00
1090529,709122,宜鼎凱基98購03,500,500,0,0.00,100.00
1090529,709123,昇達科凱基98購02,500,500,0,0.00,100.00
1090529,709124,信昌電凱基98購04,500,500,0,0.00,100.00
1090529,709125,原相凱基98購04,500,500,0,0.00,100.00
1090529,709126,勝麗凱基98購02,500,500,0,0.00,100.00
1090529,709127,群聯凱基98購03,500,500,0,0.00,100.00
1090529,709128,廣明凱基98購04,500,500,0,0.00,100.00
1090529,709129,璟德凱基98購02,500,500,0,0.00,100.00
1090529,709130,優群凱基9A購02,500,500,0,0.00,100.00
1090529,709131,穩懋凱基98購03,500,500,0,0.00,100.00
1090529,709132,穩懋凱基98購04,500,500,0,0.00,100.00
1090529,709133,頎邦凱基98購01,500,500,0,0.00,100.00
1090529,709134,環球晶統一98購01,5000,5000,0,0.00,100.00
1090529,709135,原相凱基99購01,500,500,0,0.00,100.00
1090529,709136,群聯凱基98購04,500,500,0,0.00,100.00
1090529,709137,碩禾凱基9A購01,500,500,0,0.00,100.00
1090529,709138,M31元大99購02,1000,1000,0,0.00,100.00
1090529,709139,鈊象元大99購04,800,800,0,0.00,100.00
1090529,709140,泰博國票99購01,500,500,0,0.00,100.00
1090529,709141,神盾國泰9A購01,2000,2000,0,0.00,100.00
1090529,709142,宣德富邦9A購01,7000,7000,0,0.00,100.00
1090529,709143,環球晶富邦9A購01,20000,20000,0,0.00,100.00
1090529,709144,信昌電亞東99購01,800,800,0,0.00,100.00
1090529,709145,大江永豐98購01,1000,1000,0,0.00,100.00
1090529,709146,同致永豐98購01,700,700,0,0.00,100.00
1090529,709147,合晶永豐98購02,1000,1000,0,0.00,100.00
1090529,709148,良維永豐98購01,1000,1000,0,0.00,100.00
1090529,709149,東隆興永豐98購01,2000,2000,0,0.00,100.00
1090529,709150,南光永豐98購01,2000,2000,0,0.00,100.00
1090529,709151,茂達永豐98購01,1000,1000,0,0.00,100.00
1090529,709152,新潤永豐98購01,2000,2000,0,0.00,100.00
1090529,709153,大江兆豐98購01,5000,5000,0,0.00,100.00
1090529,709154,VHQ康和98購01,20000,20000,0,0.00,100.00
1090529,709155,世界群益9A購01,3000,3000,0,0.00,100.00
1090529,709156,台燿群益99購01,2000,2000,0,0.00,100.00
1090529,709157,威剛群益9A購02,500,500,0,0.00,100.00
1090529,709158,廣明群益98購02,1500,1500,0,0.00,100.00
1090529,709159,優群群益99購02,500,500,0,0.00,100.00
1090529,709160,大江元富98購01,3500,3500,0,0.00,100.00
1090529,709161,元太台新98購01,5000,5000,0,0.00,100.00
1090529,709162,鈊象台新98購02,5000,5000,0,0.00,100.00
1090529,709163,宇峻元大99購01,2252,2252,0,0.00,100.00
1090529,709164,金居元大99購02,1000,1000,0,0.00,100.00
1090529,709165,新鉅科元大98購01,8000,8000,0,0.00,100.00
1090529,709166,上詮永豐98購01,2000,2000,0,0.00,100.00
1090529,709167,光頡永豐98購01,1500,1500,0,0.00,100.00
1090529,709168,波若威永豐98購02,1000,1000,0,0.00,100.00
1090529,709169,建榮永豐99購02,5000,5000,0,0.00,100.00
1090529,709170,健信永豐98購01,1000,1000,0,0.00,100.00
1090529,709171,璟德永豐98購01,1500,1500,0,0.00,100.00
1090529,709172,統新國泰99購01,1000,1000,0,0.00,100.00
1090529,709173,環球晶統一99購02,5000,5000,0,0.00,100.00
1090529,709174,太醫中信99購01,5000,5000,0,0.00,100.00
1090529,709175,環球晶中信98購01,5000,5000,0,0.00,100.00
1090529,709176,大江凱基98購06,500,500,0,0.00,100.00
1090529,709177,宣德凱基98購03,500,500,0,0.00,100.00
1090529,709178,精測凱基98購04,500,500,0,0.00,100.00
1090529,709179,雙鴻兆豐99購01,5000,5000,0,0.00,100.00
1090529,709180,統新康和98購02,5000,5000,0,0.00,100.00
1090529,709181,太景*群益99購01,5000,5000,0,0.00,100.00
1090529,709182,大江富邦9A購01,10000,10000,0,0.00,100.00
1090529,709183,原相麥證99購01,5000,5000,0,0.00,100.00
1090529,709184,順達麥證98購01,10000,10000,0,0.00,100.00
1090529,709185,璟德麥證98購01,12000,12000,0,0.00,100.00
1090529,709186,鈊象台新98購03,5000,5000,0,0.00,100.00
1090529,709187,大中元富98購01,5000,5000,0,0.00,100.00
1090529,709188,太景*元富98購01,5000,5000,0,0.00,100.00
1090529,709189,台半元富98購01,3500,3500,0,0.00,100.00
1090529,709190,由田元富98購01,5000,5000,0,0.00,100.00
1090529,709191,杰力元富98購01,5000,5000,0,0.00,100.00
1090529,709192,金居元富99購01,5000,5000,0,0.00,100.00
1090529,709193,美琪瑪元富98購01,5000,5000,0,0.00,100.00
1090529,709194,統新元富98購03,5000,5000,0,0.00,100.00
1090529,709195,碩禾元富9B購01,5000,5000,0,0.00,100.00
1090529,709196,群聯中信99購01,5000,5000,0,0.00,100.00
1090529,709197,大學光統一99購01,10000,10000,0,0.00,100.00
1090529,709198,原相統一99購01,5000,5000,0,0.00,100.00
1090529,709199,M31凱基98購02,500,500,0,0.00,100.00
1090529,709200,中美晶凱基98購02,500,500,0,0.00,100.00
1090529,709201,建榮凱基9A購01,500,500,0,0.00,100.00
1090529,709202,神盾凱基99購01,500,500,0,0.00,100.00
1090529,709203,金可兆豐99購01,5000,5000,0,0.00,100.00
1090529,709204,宣德兆豐98購02,5000,5000,0,0.00,100.00
1090529,709205,環球晶兆豐98購02,5000,5000,0,0.00,100.00
1090529,709206,合晶群益98購01,2300,2300,0,0.00,100.00
1090529,709207,原相群益9B購01,500,500,0,0.00,100.00
1090529,709208,統新群益98購02,5000,5000,0,0.00,100.00
1090529,709209,廣明群益98購03,1500,1500,0,0.00,100.00
1090529,709210,緯軟群益99購01,1500,1500,0,0.00,100.00
1090529,709211,鈺太群益98購01,2000,2000,0,0.00,100.00
1090529,709212,建榮國票99購02,2000,2000,0,0.00,100.00
1090529,709213,雍智國票99購02,500,500,0,0.00,100.00
1090529,709214,中美晶元大99購02,8000,8000,0,0.00,100.00
1090529,709215,金居元大9A購01,5000,5000,0,0.00,100.00
1090529,709216,威剛元大99購02,500,500,0,0.00,100.00
1090529,709217,宣德元大99購01,10000,10000,0,0.00,100.00
1090529,709218,群聯元大98購04,500,500,0,0.00,100.00
1090529,709219,碩禾元大99購02,1000,1000,0,0.00,100.00
1090529,709220,網家元大99購01,1000,1000,0,0.00,100.00
1090529,709221,環球晶元大98購04,8000,8000,0,0.00,100.00
1090529,709222,環球晶元大99購01,8000,8000,0,0.00,100.00
1090529,709223,雙鴻元大99購05,1400,2000,-600,-30.00,100.00
1090529,709224,穩懋元大98購02,5000,5000,0,0.00,100.00
1090529,709225,穩懋元大99購01,10000,10000,0,0.00,100.00
1090529,709226,泰博國泰99購01,1000,1000,0,0.00,100.00
1090529,709227,大江富邦9A購02,10000,10000,0,0.00,100.00
1090529,709228,中美晶富邦9A購01,10000,10000,0,0.00,100.00
1090529,709229,精測富邦99購01,10000,10000,0,0.00,100.00
1090529,709230,環球晶富邦9B購01,20000,20000,0,0.00,100.00
1090529,709231,威剛麥證98購01,10000,10000,0,0.00,100.00
1090529,709232,群聯麥證98購01,10000,10000,0,0.00,100.00
1090529,709233,聯亞麥證98購01,10000,10000,0,0.00,100.00
1090529,709234,力旺元富98購01,3500,3500,0,0.00,100.00
1090529,709235,大江元富98購02,3500,3500,0,0.00,100.00
1090529,709236,原相元富98購01,3500,3500,0,0.00,100.00
1090529,709237,新鉅科元富98購01,3500,3500,0,0.00,100.00
1090529,709238,聚積元富98購01,3500,3500,0,0.00,100.00
1090529,709239,環球晶第一01購01,17000,17000,0,0.00,100.00
1090529,709240,M31永豐98購01,1000,2000,-1000,-50.00,100.00
1090529,709241,凡甲永豐98購01,1000,1000,0,0.00,100.00
1090529,709242,大中永豐98購01,1000,1000,0,0.00,100.00
1090529,709243,迅得永豐98購01,1000,1000,0,0.00,100.00
1090529,709244,杰力永豐98購01,1500,1500,0,0.00,100.00
1090529,709245,統新永豐98購02,1000,1000,0,0.00,100.00
1090529,709246,晶焱永豐98購01,1500,1500,0,0.00,100.00
1090529,709247,網龍永豐98購01,1000,1000,0,0.00,100.00
1090529,709248,優群永豐98購01,500,500,0,0.00,100.00
1090529,709249,原相台新9A購01,5000,5000,0,0.00,100.00
1090529,709250,聯亞台新9A購01,5000,5000,0,0.00,100.00
1090529,709251,前鼎統一99購01,5000,5000,0,0.00,100.00
1090529,709252,聯亞中信98購01,5000,5000,0,0.00,100.00
1090529,709253,晶焱凱基98購03,500,500,0,0.00,100.00
1090529,709254,群聯凱基99購01,500,500,0,0.00,100.00
1090529,709255,神盾台新98購02,5000,5000,0,0.00,100.00
1090529,709256,精測台新99購02,5000,5000,0,0.00,100.00
1090529,709257,VHQ元富98購01,5000,5000,0,0.00,100.00
1090529,709258,前鼎元富98購01,5000,5000,0,0.00,100.00
1090529,709259,精測元富98購02,3500,3500,0,0.00,100.00
1090529,709260,中美晶國票98購01,5800,800,5000,625.00,100.00
1090529,709261,保瑞國票98購01,1000,1000,0,0.00,100.00
1090529,709262,前鼎國票99購01,2000,2000,0,0.00,100.00
1090529,709263,原相國票99購01,500,500,0,0.00,100.00
1090529,709264,泰博國票99購02,500,500,0,0.00,100.00
1090529,709265,統新國票99購01,3500,3500,0,0.00,100.00
1090529,709266,六角兆豐98購01,5000,5000,0,0.00,100.00
1090529,709267,宇峻群益9A購01,500,500,0,0.00,100.00
1090529,709268,博智群益98購01,5000,5000,0,0.00,100.00
1090529,709269,網龍群益98購03,1500,1500,0,0.00,100.00
1090529,709270,太景*國泰9A購01,2100,2100,0,0.00,100.00
1090529,709271,前鼎國泰99購01,500,500,0,0.00,100.00
1090529,709272,新鉅科國泰99購01,500,500,0,0.00,100.00
1090529,709273,環宇富邦9A購01,5000,5000,0,0.00,100.00
1090529,709274,大江元大98購02,1000,1000,0,0.00,100.00
1090529,709275,前鼎元大99購01,10000,10000,0,0.00,100.00
1090529,709276,威剛元大9A購01,500,500,0,0.00,100.00
1090529,709277,神盾元大9A購01,1000,1000,0,0.00,100.00
1090529,709278,群聯元大99購02,500,500,0,0.00,100.00
1090529,709279,緯軟元大98購02,8000,8000,0,0.00,100.00
1090529,709280,璟德元大98購01,1000,1000,0,0.00,100.00
1090529,709281,中美晶日盛9A購01,10000,10000,0,0.00,100.00
1090529,709282,伍豐永豐98購01,1000,1000,0,0.00,100.00
1090529,709283,兆利永豐98購01,1000,1000,0,0.00,100.00
1090529,709284,宜鼎永豐98購01,1000,1000,0,0.00,100.00
1090529,709285,前鼎永豐98購01,2000,2000,0,0.00,100.00
1090529,709286,建榮永豐9A購01,5000,5000,0,0.00,100.00
1090529,709287,新鉅科永豐98購01,1000,1000,0,0.00,100.00
1090529,709288,聯亞永豐98購01,1000,1000,0,0.00,100.00
1090529,709289,雙鴻永豐99購01,5000,5000,0,0.00,100.00
1090529,709290,金居凱基98購02,500,500,0,0.00,100.00
1090529,709291,威剛凱基9A購01,1785,1785,0,0.00,100.00
1090529,709292,環球晶凱基98購04,500,500,0,0.00,100.00
1090529,709293,環球晶康和98購01,5000,5000,0,0.00,100.00
1090529,709294,大江群益98購01,1600,1600,0,0.00,100.00
1090529,709295,宇峻群益9A購02,1033,1033,0,0.00,100.00
1090529,709296,神盾群益9A購02,5000,5000,0,0.00,100.00
1090529,709297,宣德國票99購01,2500,2500,0,0.00,100.00
1090529,709298,群聯國票99購01,500,500,0,0.00,100.00
1090529,709299,VHQ國泰99購01,1000,1000,0,0.00,100.00
1090529,709300,宣德國泰9A購01,3800,3800,0,0.00,100.00
1090529,709301,大宇資永豐98購02,1000,1000,0,0.00,100.00
1090529,709302,六角永豐98購01,2000,2000,0,0.00,100.00
1090529,709303,亞泰永豐98購01,1500,1500,0,0.00,100.00
1090529,709304,信昌電永豐98購01,1000,1000,0,0.00,100.00
1090529,709305,宣德永豐98購01,1500,1500,0,0.00,100.00
1090529,709306,原相永豐98購02,2500,2500,0,0.00,100.00
1090529,709307,神盾永豐99購01,5000,5000,0,0.00,100.00
1090529,709308,雙美永豐99購01,5000,5000,0,0.00,100.00
1090529,709309,譜瑞永豐98購01,500,1000,-500,-50.00,100.00
1090529,709310,合晶元富98購01,3000,3000,0,0.00,100.00
1090529,709311,前鼎元富98購02,5000,5000,0,0.00,100.00
1090529,709312,大學光元大99購01,600,600,0,0.00,100.00
1090529,709313,保瑞元大98購01,1000,1000,0,0.00,100.00
1090529,709314,前鼎元大99購02,10000,10000,0,0.00,100.00
1090529,709315,胡連元大98購01,7000,7000,0,0.00,100.00
1090529,709316,神盾元大9A購02,1000,1000,0,0.00,100.00
1090529,709317,群聯元大98購05,543,543,0,0.00,100.00
1090529,709318,環球晶元大98購09,5000,5000,0,0.00,100.00
1090529,709319,環球晶元大98購10,8000,8000,0,0.00,100.00
1090529,709320,雙鴻元大9A購01,1200,1500,-300,-20.00,100.00
1090529,709321,譜瑞元大98購03,5000,5000,0,0.00,100.00
1090529,709322,六角台新98購01,5000,5000,0,0.00,100.00
1090529,709323,群聯麥證98購02,5000,5000,0,0.00,100.00
1090529,709324,同致元富98購01,5000,5000,0,0.00,100.00
1090529,709325,神盾元富99購01,5000,5000,0,0.00,100.00
1090529,709326,群聯元富98購01,3500,3500,0,0.00,100.00
1090529,709327,碩禾元富9B購02,5000,5000,0,0.00,100.00
1090529,709328,三貝德凱基98購01,566,566,0,0.00,100.00
1090529,709329,大江凱基98購07,500,500,0,0.00,100.00
1090529,709330,威剛凱基9A購02,694,694,0,0.00,100.00
1090529,709331,雍智凱基99購01,500,500,0,0.00,100.00
1090529,709332,環球晶凱基98購05,500,500,0,0.00,100.00
1090529,709333,聯亞凱基99購03,500,500,0,0.00,100.00
1090529,709334,穩懋凱基98購06,500,500,0,0.00,100.00
1090529,709335,泰博永豐98購01,500,500,0,0.00,100.00
1090529,709336,博智永豐98購01,500,500,0,0.00,100.00
1090529,709337,緯軟永豐98購01,1000,1000,0,0.00,100.00
1090529,709338,環宇永豐98購02,1000,1000,0,0.00,100.00
1090529,709339,VHQ統一99購01,5000,5000,0,0.00,100.00
1090529,709340,大學光統一9A購01,5000,5000,0,0.00,100.00
1090529,709341,廣明統一99購01,5000,5000,0,0.00,100.00
1090529,709342,穩懋統一98購04,15000,15000,0,0.00,100.00
1090529,709343,凡甲元大98購03,600,600,0,0.00,100.00
1090529,709344,中美晶元大98購03,10000,10000,0,0.00,100.00
1090529,709345,宇峻元大99購02,1000,1000,0,0.00,100.00
1090529,709346,博智元大98購01,800,800,0,0.00,100.00
1090529,709347,群聯元大98購06,800,800,0,0.00,100.00
1090529,709348,網家元大98購01,1000,1000,0,0.00,100.00
1090529,709349,廣明元大98購01,1000,1000,0,0.00,100.00
1090529,709350,中美晶兆豐99購01,5000,5000,0,0.00,100.00
1090529,709351,泰博兆豐98購01,5000,5000,0,0.00,100.00
1090529,709352,精華兆豐99購01,5000,5000,0,0.00,100.00
1090529,709353,頎邦兆豐98購01,5000,5000,0,0.00,100.00
1090529,709354,M31群益9A購01,1600,1600,0,0.00,100.00
1090529,709355,中美晶群益98購02,1164,1164,0,0.00,100.00
1090529,709356,宜鼎群益98購02,1500,1500,0,0.00,100.00
1090529,709357,原相群益98購03,2427,2427,0,0.00,100.00
1090529,709358,譜瑞群益98購01,500,500,0,0.00,100.00
1090529,709359,璟德國泰99購01,1500,1500,0,0.00,100.00
1090529,709360,神盾富邦9A購01,10000,10000,0,0.00,100.00
1090529,709361,群聯凱基98購05,500,500,0,0.00,100.00
1090529,709362,網家凱基99購01,500,500,0,0.00,100.00
1090529,709363,晟德凱基98購01,500,500,0,0.00,100.00
1090529,709364,神盾統一98購02,5000,5000,0,0.00,100.00
1090529,709365,VHQ元大99購02,1000,1000,0,0.00,100.00
1090529,709366,中美晶元大98購04,10000,10000,0,0.00,100.00
1090529,709367,兆利元大99購01,1000,1000,0,0.00,100.00
1090529,709368,原相元大9A購02,5000,5000,0,0.00,100.00
1090529,709369,群聯元大98購07,500,500,0,0.00,100.00
1090529,709370,碩禾元大99購03,1000,1000,0,0.00,100.00
1090529,709371,廣明元大98購02,1000,1000,0,0.00,100.00
1090529,709372,神盾第一9C購01,5000,5000,0,0.00,100.00
1090529,709373,三貝德永豐99購01,3031,3031,0,0.00,100.00
1090529,709374,大田永豐98購01,1500,1500,0,0.00,100.00
1090529,709375,大江永豐98購03,1000,1000,0,0.00,100.00
1090529,709376,旺矽永豐98購01,1000,1000,0,0.00,100.00
1090529,709377,勝麗永豐98購01,1000,1000,0,0.00,100.00
1090529,709378,宜鼎兆豐99購01,5000,5000,0,0.00,100.00
1090529,709379,神盾兆豐99購01,5000,5000,0,0.00,100.00
1090529,709380,穩懋兆豐99購01,5000,5000,0,0.00,100.00
1090529,709381,網家康和98購01,5000,5000,0,0.00,100.00
1090529,709382,大學光群益99購01,2300,2300,0,0.00,100.00
1090529,709383,六角群益98購03,500,500,0,0.00,100.00
1090529,709384,迅得群益9A購01,500,500,0,0.00,100.00
1090529,709385,環宇群益99購01,1600,1600,0,0.00,100.00
1090529,709386,鈺太群益98購02,5000,5000,0,0.00,100.00
1090529,709387,大學光統一99購02,5000,5000,0,0.00,100.00
1090529,709388,穩懋統一98購05,5000,5000,0,0.00,100.00
1090529,709389,原相中信9A購01,5000,5000,0,0.00,100.00
1090529,709390,大學光凱基98購01,500,500,0,0.00,100.00
1090529,709391,六角凱基98購01,500,500,0,0.00,100.00
1090529,709392,穩懋凱基98購07,500,500,0,0.00,100.00
1090529,709393,宜鼎元富98購01,3500,3500,0,0.00,100.00
1090529,709394,群聯元富98購02,5000,5000,0,0.00,100.00
1090529,709395,譜瑞元富98購02,3500,3500,0,0.00,100.00
1090529,709396,台燿元大98購01,6000,6000,0,0.00,100.00
1090529,709397,神盾元大99購03,1000,1000,0,0.00,100.00
1090529,709398,精測元大99購01,1500,1500,0,0.00,100.00
1090529,709399,穩懋元大98購05,5000,5000,0,0.00,100.00
1090529,709400,穩懋元大98購06,5000,5000,0,0.00,100.00
1090529,709401,穩懋元大98購07,5000,5000,0,0.00,100.00
1090529,709402,前鼎國票99購02,3000,3000,0,0.00,100.00
1090529,709403,雙美國票9B購01,4000,4000,0,0.00,100.00
1090529,709404,雙鴻國票9A購01,1000,1000,0,0.00,100.00
1090529,709405,譜瑞國票99購01,500,500,0,0.00,100.00
1090529,709406,博智國泰9A購01,500,500,0,0.00,100.00
1090529,709407,大學光富邦9C購01,15000,15000,0,0.00,100.00
1090529,709408,VHQ永豐99購01,2044,2044,0,0.00,100.00
1090529,709409,力致永豐99購01,2000,2000,0,0.00,100.00
1090529,709410,大學光永豐98購01,1000,1500,-500,-33.33,100.00
1090529,709411,台燿永豐98購01,1000,1000,0,0.00,100.00
1090529,709412,立端永豐98購01,1000,1000,0,0.00,100.00
1090529,709413,合晶永豐98購03,1000,1000,0,0.00,100.00
1090529,709414,東隆興永豐98購02,2000,2000,0,0.00,100.00
1090529,709415,群聯永豐98購01,1000,1000,0,0.00,100.00
1090529,709416,緯軟永豐98購02,1000,1000,0,0.00,100.00
1090529,709417,穩懋永豐98購01,1000,1000,0,0.00,100.00
1090529,709418,頎邦永豐98購01,1000,1000,0,0.00,100.00
1090529,709419,泰博兆豐98購02,5000,5000,0,0.00,100.00
1090529,709420,群聯兆豐99購01,5000,5000,0,0.00,100.00
1090529,709421,大江群益98購02,500,500,0,0.00,100.00
1090529,709422,中美晶群益99購01,735,735,0,0.00,100.00
1090529,709423,亞泰群益98購01,2300,2300,0,0.00,100.00
1090529,709424,南光群益98購01,1900,1900,0,0.00,100.00
1090529,709425,璟德群益98購02,800,800,0,0.00,100.00
1090529,709426,智擎中信98購01,5000,5000,0,0.00,100.00
1090529,709427,力旺凱基98購01,500,500,0,0.00,100.00
1090529,709428,三貝德凱基99購02,500,500,0,0.00,100.00
1090529,709429,環球晶凱基99購03,500,500,0,0.00,100.00
1090529,709430,穩懋凱基99購01,500,500,0,0.00,100.00
1090529,709431,M31永豐99購01,2500,3000,-500,-16.66,100.00
1090529,709432,力旺永豐98購01,1000,1000,0,0.00,100.00
1090529,709433,大學光永豐98購02,1000,1500,-500,-33.33,100.00
1090529,709434,宣德永豐98購02,1000,1000,0,0.00,100.00
1090529,709435,元太亞東99購01,1000,1000,0,0.00,100.00
1090529,709436,穩懋麥證98購01,10000,10000,0,0.00,100.00
1090529,709437,M31元富98購01,5000,5000,0,0.00,100.00
1090529,709438,光頡元富98購01,5000,5000,0,0.00,100.00
1090529,709439,優群元富98購01,3000,3000,0,0.00,100.00
1090529,709440,三貝德元大99購01,1500,1500,0,0.00,100.00
1090529,709441,神盾元大9A購03,5000,5000,0,0.00,100.00
1090529,709442,神準元大98購01,10000,10000,0,0.00,100.00
1090529,709443,統新元大99購01,1000,1000,0,0.00,100.00
1090529,709444,博智元大98購02,6000,6000,0,0.00,100.00
1090529,709445,雍智元大98購01,600,800,-200,-25.00,100.00
1090529,709446,網家元大98購02,2000,2000,0,0.00,100.00
1090529,709447,緯軟元大99購01,1000,1000,0,0.00,100.00
1090529,709448,環球晶元大98購13,8000,8000,0,0.00,100.00
1090529,709449,穩懋元大98購08,5000,5000,0,0.00,100.00
1090529,709450,宇峻國票99購01,1000,1000,0,0.00,100.00
1090529,709451,大學光兆豐99購01,5000,5000,0,0.00,100.00
1090529,709452,原相兆豐99購01,5000,5000,0,0.00,100.00
1090529,709453,穩懋兆豐98購02,5000,5000,0,0.00,100.00
1090529,709454,網家群益98購01,1500,1500,0,0.00,100.00
1090529,709455,網家群益98購02,1000,1000,0,0.00,100.00
1090529,709456,穩懋統一9A購01,7500,7500,0,0.00,100.00
1090529,709457,譜瑞中信9A購01,5000,5000,0,0.00,100.00
1090529,709458,大江凱基99購01,500,500,0,0.00,100.00
1090529,709459,中美晶凱基99購01,500,500,0,0.00,100.00
1090529,709460,穩懋凱基99購02,500,500,0,0.00,100.00
1090529,709461,譜瑞麥證98購01,10000,10000,0,0.00,100.00
1090529,709462,環球晶元富98購02,500,500,0,0.00,100.00
1090529,709463,環球晶元富98購03,5000,5000,0,0.00,100.00
1090529,709464,中美晶元大98購05,6000,6000,0,0.00,100.00
1090529,709465,精測元大99購02,6000,6000,0,0.00,100.00
1090529,709466,環球晶元大98購14,8000,8000,0,0.00,100.00
1090529,709467,譜瑞元大98購04,5000,5000,0,0.00,100.00
1090529,709468,穩懋日盛99購01,10000,10000,0,0.00,100.00
1090529,709469,久元永豐98購01,1000,1000,0,0.00,100.00
1090529,709470,原相永豐99購01,2500,2500,0,0.00,100.00
1090529,709471,環球晶永豐98購02,1000,1000,0,0.00,100.00
1090529,709472,譜瑞永豐98購02,1000,1000,0,0.00,100.00
1090529,709473,網家台新98購01,5000,5000,0,0.00,100.00
1090529,709474,台燿兆豐98購01,5000,5000,0,0.00,100.00
1090529,709475,晟德兆豐99購01,5000,5000,0,0.00,100.00
1090529,709476,旺矽國票99購01,700,1000,-300,-30.00,100.00
1090529,709477,璟德國票99購01,500,500,0,0.00,100.00
1090529,709478,聯亞國票99購02,800,800,0,0.00,100.00
1090529,709479,譜瑞國票99購02,500,500,0,0.00,100.00
1090529,709480,宇峻康和98購01,5000,5000,0,0.00,100.00
1090529,709481,凡甲群益98購02,500,500,0,0.00,100.00
1090529,709482,大宇資群益9A購01,5000,5000,0,0.00,100.00
1090529,709483,迅得群益9A購02,5000,5000,0,0.00,100.00
1090529,709484,金居群益9A購01,3000,3000,0,0.00,100.00
1090529,709485,晶焱群益9A購01,2000,2000,0,0.00,100.00
1090529,709486,群聯群益98購02,500,500,0,0.00,100.00
1090529,709487,環球晶群益98購02,500,500,0,0.00,100.00
1090529,709488,大江國泰9A購02,2000,2000,0,0.00,100.00
1090529,709489,譜瑞國泰9A購01,500,500,0,0.00,100.00
1090529,709490,穩懋富邦9A購01,15000,15000,0,0.00,100.00
1090529,709491,譜瑞富邦9A購01,20000,20000,0,0.00,100.00
1090529,709492,同致元富9B購01,5000,5000,0,0.00,100.00
1090529,709493,博智元富98購01,3500,3500,0,0.00,100.00
1090529,709494,威剛統一9A購02,5000,5000,0,0.00,100.00
1090529,709495,譜瑞統一99購01,15000,15000,0,0.00,100.00
1090529,709496,中美晶凱基99購02,500,500,0,0.00,100.00
1090529,709497,網家凱基98購01,500,500,0,0.00,100.00
1090529,709498,網龍凱基98購02,500,500,0,0.00,100.00
1090529,709499,環球晶凱基98購07,500,500,0,0.00,100.00
1090529,709500,環球晶凱基99購04,764,764,0,0.00,100.00
1090529,709501,譜瑞凱基98購01,500,500,0,0.00,100.00
1090529,709502,譜瑞凱基99購01,500,500,0,0.00,100.00
1090529,709503,譜瑞凱基9A購01,500,500,0,0.00,100.00
1090529,709504,合晶兆豐98購01,5000,5000,0,0.00,100.00
1090529,709505,威剛兆豐99購01,5000,5000,0,0.00,100.00
1090529,709506,聚積兆豐99購01,5000,5000,0,0.00,100.00
1090529,709507,中美晶永豐98購02,1000,1000,0,0.00,100.00
1090529,709508,尼克森永豐98購01,2000,2000,0,0.00,100.00
1090529,709509,安勤永豐98購01,1500,1500,0,0.00,100.00
1090529,709510,信驊永豐98購01,500,1500,-1000,-66.66,100.00
1090529,709511,博智永豐98購02,1500,1500,0,0.00,100.00
1090529,709512,網家永豐98購01,1000,1000,0,0.00,100.00
1090529,709513,中美晶國票98購02,1000,1000,0,0.00,100.00
1090529,709514,網家國票99購01,700,1000,-300,-30.00,100.00
1090529,709515,穩懋國票99購01,500,500,0,0.00,100.00
1090529,709516,中美晶國泰9A購01,3000,3000,0,0.00,100.00
1090529,709517,太景*國泰9A購02,500,500,0,0.00,100.00
1090529,709518,宇峻國泰9A購01,1000,1000,0,0.00,100.00
1090529,709519,威剛國泰99購01,500,500,0,0.00,100.00
1090529,709520,原相國泰99購01,500,500,0,0.00,100.00
1090529,709521,博智國泰9A購02,3000,3000,0,0.00,100.00
1090529,709522,環球晶國泰99購02,510,510,0,0.00,100.00
1090529,709523,環球晶國泰9A購01,1600,1600,0,0.00,100.00
1090529,709524,鈊象國泰9A購01,1000,1000,0,0.00,100.00
1090529,709525,譜瑞台新98購01,5000,5000,0,0.00,100.00
1090529,709526,大學光富邦98購01,15000,15000,0,0.00,100.00
1090529,709527,力旺群益99購01,1500,1500,0,0.00,100.00
1090529,709528,中美晶群益99購02,2300,2300,0,0.00,100.00
1090529,709529,宜鼎群益98購03,1500,1500,0,0.00,100.00
1090529,709530,神盾群益9A購03,2300,2300,0,0.00,100.00
1090529,709531,碩禾群益98購01,1000,1000,0,0.00,100.00
1090529,709532,精測群益98購01,1650,1650,0,0.00,100.00
1090529,709533,譜瑞群益98購02,1600,1600,0,0.00,100.00
1090529,709534,M31元大9A購01,1000,1000,0,0.00,100.00
1090529,709535,宣德元大99購02,1000,1000,0,0.00,100.00
1090529,709536,網家元大98購03,1000,1000,0,0.00,100.00
1090529,709537,環球晶元大9A購01,8000,8000,0,0.00,100.00
1090529,709538,穩懋元大98購09,5000,5000,0,0.00,100.00
1090529,709539,鈺太元大99購03,1000,1000,0,0.00,100.00
1090529,709540,雍智元富98購01,4000,4000,0,0.00,100.00
1090529,709541,環球晶中信99購03,5000,5000,0,0.00,100.00
1090529,709542,大江凱基9A購01,1049,1049,0,0.00,100.00
1090529,709543,中美晶凱基9A購02,500,500,0,0.00,100.00
1090529,709544,台半凱基98購02,500,500,0,0.00,100.00
1090529,709545,安勤凱基98購01,500,500,0,0.00,100.00
1090529,709546,環球晶凱基99購05,500,500,0,0.00,100.00
1090529,709547,穩懋凱基98購09,500,500,0,0.00,100.00
1090529,709548,威剛統一99購01,5500,5500,0,0.00,100.00
1090529,709549,網家統一9A購01,5000,5000,0,0.00,100.00
1090529,709550,環球晶統一99購03,17000,17000,0,0.00,100.00
1090529,709551,大江元大99購02,1000,1000,0,0.00,100.00
1090529,709552,神盾元大99購04,1000,1000,0,0.00,100.00
1090529,709553,博智元大98購03,1000,1000,0,0.00,100.00
1090529,709554,群聯元大99購03,500,500,0,0.00,100.00
1090529,709555,譜瑞元大98購06,5000,5000,0,0.00,100.00
1090529,709556,威剛國票99購01,1000,1000,0,0.00,100.00
1090529,709557,神盾國票99購01,2000,2000,0,0.00,100.00
1090529,709558,廣明國票99購01,1000,1000,0,0.00,100.00
1090529,709559,環球晶國票99購01,1000,1000,0,0.00,100.00
1090529,709560,雙美國票99購02,500,500,0,0.00,100.00
1090529,709561,聚積國泰99購01,3000,3000,0,0.00,100.00
1090529,709562,中美晶群益98購03,500,500,0,0.00,100.00
1090529,709563,合晶群益98購02,1600,1600,0,0.00,100.00
1090529,709564,旺矽群益99購01,1600,1600,0,0.00,100.00
1090529,709565,宣德群益98購02,5000,5000,0,0.00,100.00
1090529,709566,鈺太群益98購03,5000,5000,0,0.00,100.00
1090529,709567,穩懋台新98購02,5000,5000,0,0.00,100.00
1090529,709568,原相亞東99購02,800,800,0,0.00,100.00
1090529,709569,群聯亞東98購01,500,500,0,0.00,100.00
1090529,709570,直得永豐98購01,500,500,0,0.00,100.00
1090529,709571,網龍永豐98購02,2000,2000,0,0.00,100.00
1090529,709572,聚積永豐98購01,1054,1054,0,0.00,100.00
1090529,709573,鈺太永豐98購01,1000,1000,0,0.00,100.00
1090529,709574,元太台新98購02,5000,5000,0,0.00,100.00
1090529,709575,中美晶元大98購06,10000,10000,0,0.00,100.00
1090529,709576,原相元大9A購03,5000,5000,0,0.00,100.00
1090529,709577,泰博元大98購01,600,600,0,0.00,100.00
1090529,709578,聚積元大9A購01,1000,1000,0,0.00,100.00
1090529,709579,環球晶元大98購15,10000,10000,0,0.00,100.00
1090529,709580,宇峻中信98購01,5000,5000,0,0.00,100.00
1090529,709581,原相統一99購02,5000,5000,0,0.00,100.00
1090529,709582,雙鴻統一99購02,5000,5000,0,0.00,100.00
1090529,709583,大宇資凱基99購01,500,500,0,0.00,100.00
1090529,709584,威剛凱基98購01,500,500,0,0.00,100.00
1090529,709585,博智凱基9A購01,5609,609,5000,821.01,100.00
1090529,709586,精測凱基99購02,500,500,0,0.00,100.00
1090529,709587,譜瑞凱基98購02,541,541,0,0.00,100.00
1090529,709588,中美晶群益98購04,1700,1700,0,0.00,100.00
1090529,709589,元太群益99購01,1500,1500,0,0.00,100.00
1090529,709590,網家群益98購03,1500,1500,0,0.00,100.00
1090529,709591,譜瑞群益98購03,1600,1600,0,0.00,100.00
1090529,709592,泰博國票99購03,600,600,0,0.00,100.00
1090529,709593,合晶國泰99購02,1500,1500,0,0.00,100.00
1090529,709594,保瑞國泰9A購01,4000,4000,0,0.00,100.00
1090529,709595,璟德兆豐99購01,10000,10000,0,0.00,100.00
1090529,709596,亞泰永豐99購02,1500,1500,0,0.00,100.00
1090529,709597,保瑞永豐98購01,1000,1000,0,0.00,100.00
1090529,709598,建榮永豐99購03,5000,5000,0,0.00,100.00
1090529,709599,神盾永豐98購01,5000,5000,0,0.00,100.00
1090529,709600,新鉅科永豐98購02,1300,1300,0,0.00,100.00
1090529,709601,雙美永豐99購02,5000,5000,0,0.00,100.00
1090529,709602,穩懋永豐98購03,1500,1500,0,0.00,100.00
1090529,709603,晟德永豐98購01,1000,1000,0,0.00,100.00
1090529,709604,鈊象永豐98購03,5000,5000,0,0.00,100.00
1090529,709605,中美晶元富99購02,5000,5000,0,0.00,100.00
1090529,709606,尼克森元富98購01,5000,5000,0,0.00,100.00
1090529,709607,博智元富98購02,5000,5000,0,0.00,100.00
1090529,709608,網龍元富98購01,5000,5000,0,0.00,100.00
1090529,709609,穩懋元富02購01,4500,4500,0,0.00,100.00
1090529,709610,穩懋元富02購02,3500,3500,0,0.00,100.00
1090529,709611,穩懋元富02購03,3500,3500,0,0.00,100.00
1090529,709612,穩懋元富02購04,3500,3500,0,0.00,100.00
1090529,709613,凡甲凱基98購02,500,500,0,0.00,100.00
1090529,709614,中美晶凱基99購03,500,500,0,0.00,100.00
1090529,709615,緯軟凱基98購04,500,500,0,0.00,100.00
1090529,709616,大江兆豐99購01,5000,5000,0,0.00,100.00
1090529,709617,大江群益98購03,1600,1600,0,0.00,100.00
1090529,709618,安勤群益98購01,2500,2500,0,0.00,100.00
1090529,709619,杰力群益98購01,5000,5000,0,0.00,100.00
1090529,709620,群聯群益98購03,500,500,0,0.00,100.00
1090529,709621,環球晶群益98購04,1550,1550,0,0.00,100.00
1090529,709622,M31永豐98購02,1500,2000,-500,-25.00,100.00
1090529,709623,尼克森永豐98購02,3000,3000,0,0.00,100.00
1090529,709624,泰博永豐99購01,2000,2000,0,0.00,100.00
1090529,709625,力旺國票99購01,1000,1000,0,0.00,100.00
1090529,709626,建榮國票9A購01,500,500,0,0.00,100.00
1090529,709627,博智國票99購01,800,800,0,0.00,100.00
1090529,709628,優群國票99購01,500,500,0,0.00,100.00
1090529,709629,環球晶國票99購02,500,500,0,0.00,100.00
1090529,709630,聯亞國票99購03,500,500,0,0.00,100.00
1090529,709631,大中元大98購01,1500,1500,0,0.00,100.00
1090529,709632,合晶元大99購01,8000,8000,0,0.00,100.00
1090529,709633,宜鼎元大99購01,1000,1000,0,0.00,100.00
1090529,709634,保瑞元大98購02,8000,8000,0,0.00,100.00
1090529,709635,譜瑞元大98購07,8000,8000,0,0.00,100.00
1090529,709636,晟德元大98購01,1000,1000,0,0.00,100.00
1090529,709637,安勤元富98購01,4000,4000,0,0.00,100.00
1090529,709638,威剛富邦9A購01,10000,10000,0,0.00,100.00
1090529,709639,雙鴻富邦99購01,9000,9000,0,0.00,100.00
1090529,709640,博智台新98購01,5000,5000,0,0.00,100.00
1090529,709641,久元群益98購01,1600,1600,0,0.00,100.00
1090529,709642,群聯群益98購04,500,500,0,0.00,100.00
1090529,709643,聖暉群益98購01,2000,2000,0,0.00,100.00
1090529,709644,璟德中信98購01,5000,5000,0,0.00,100.00
1090529,709645,合晶統一9A購01,5000,5000,0,0.00,100.00
1090529,709646,神盾統一99購01,5000,5000,0,0.00,100.00
1090529,709647,環球晶統一99購04,15000,15000,0,0.00,100.00
1090529,709648,穩懋統一98購06,20000,20000,0,0.00,100.00
1090529,709649,中美晶凱基99購04,500,500,0,0.00,100.00
1090529,709650,精測凱基98購05,500,500,0,0.00,100.00
1090529,709651,聯亞凱基99購04,500,500,0,0.00,100.00
1090529,709652,大學光國票99購01,500,500,0,0.00,100.00
1090529,709653,原相國票99購02,1500,1500,0,0.00,100.00
1090529,709654,安勤國泰99購01,1400,1400,0,0.00,100.00
1090529,709655,大江元大98購03,1000,1000,0,0.00,100.00
1090529,709656,中美晶元大99購03,6000,6000,0,0.00,100.00
1090529,709657,宇峻元大99購03,1000,1000,0,0.00,100.00
1090529,709658,博智元大99購01,1000,1000,0,0.00,100.00
1090529,709659,網家元大99購02,5000,5000,0,0.00,100.00
1090529,709660,環球晶元大98購16,8000,8000,0,0.00,100.00
1090529,709661,環球晶元大99購02,8000,8000,0,0.00,100.00
1090529,709662,穩懋元大98購10,5000,5000,0,0.00,100.00
1090529,709663,譜瑞元大98購08,5000,5000,0,0.00,100.00
1090529,709664,神盾第一9C購02,5000,5000,0,0.00,100.00
1090529,709665,台半永豐98購01,1000,1000,0,0.00,100.00
1090529,709666,兆利永豐98購02,1000,1000,0,0.00,100.00
1090529,709667,金居永豐98購02,1000,1000,0,0.00,100.00
1090529,709668,宣德永豐98購03,1000,1000,0,0.00,100.00
1090529,709669,博智永豐99購01,2500,2500,0,0.00,100.00
1090529,709670,晶焱永豐98購03,1500,1500,0,0.00,100.00
1090529,709671,雍智永豐99購01,2075,2075,0,0.00,100.00
1090529,709672,環宇永豐98購03,1000,1000,0,0.00,100.00
1090529,709673,環球晶元富98購04,500,500,0,0.00,100.00
1090529,709674,力旺元大98購01,5000,5000,0,0.00,100.00
1090529,709675,力旺元大98購02,6000,6000,0,0.00,100.00
1090529,709676,中美晶元大98購08,6000,6000,0,0.00,100.00
1090529,709677,聚積元大99購01,1000,1000,0,0.00,100.00
1090529,709678,聯亞元大98購05,1000,1000,0,0.00,100.00
1090529,709679,譜瑞元大98購09,8000,8000,0,0.00,100.00
1090529,709680,中美晶國票99購01,1000,1000,0,0.00,100.00
1090529,709681,宣德國票98購02,3000,3000,0,0.00,100.00
1090529,709682,建榮國票9A購02,500,500,0,0.00,100.00
1090529,709683,網家國票99購02,600,800,-200,-25.00,100.00
1090529,709684,雍智國泰9A購01,4000,4000,0,0.00,100.00
1090529,709685,安勤統一98購01,5000,5000,0,0.00,100.00
1090529,709686,元太中信9A購01,5000,5000,0,0.00,100.00
1090529,709687,台燿中信9A購01,5000,5000,0,0.00,100.00
1090529,709688,合晶中信9A購02,10000,10000,0,0.00,100.00
1090529,709689,中美晶凱基99購05,500,500,0,0.00,100.00
1090529,709690,六角凱基99購03,500,500,0,0.00,100.00
1090529,709691,智崴凱基98購01,500,500,0,0.00,100.00
1090529,709692,昇達科永豐98購01,1000,1000,0,0.00,100.00
1090529,709693,建榮永豐99購04,5000,5000,0,0.00,100.00
1090529,709694,順達永豐98購01,500,700,-200,-28.57,100.00
1090529,709695,精測永豐98購01,1000,1000,0,0.00,100.00
1090529,709696,穩懋永豐98購04,2000,2000,0,0.00,100.00
1090529,709697,鈊象永豐99購01,5000,5000,0,0.00,100.00
1090529,709698,力旺中信99購01,5000,5000,0,0.00,100.00
1090529,709699,凡甲元大9A購02,500,500,0,0.00,100.00
1090529,709700,安勤元大99購01,1000,1000,0,0.00,100.00
1090529,709701,宏捷科元大99購01,5000,5000,0,0.00,100.00
1090529,709702,宜鼎元大9A購01,1200,1500,-300,-20.00,100.00
1090529,709703,直得元大99購01,1000,1000,0,0.00,100.00
1090529,709704,南光元大99購01,3500,3500,0,0.00,100.00
1090529,709705,原相元大99購03,1500,1500,0,0.00,100.00
1090529,709706,新鉅科元大99購01,8000,8000,0,0.00,100.00
1090529,709707,穩懋元大99購02,5000,5000,0,0.00,100.00
1090529,709708,晟德元大99購01,10000,10000,0,0.00,100.00
1090529,709709,大宇資國票9A購01,5000,5000,0,0.00,100.00
1090529,709710,宏捷科國票9A購01,500,500,0,0.00,100.00
1090529,709711,穩懋國泰9A購01,4000,4000,0,0.00,100.00
1090529,709712,穩懋國泰9B購01,500,500,0,0.00,100.00
1090529,709713,亞泰元富99購01,3500,3500,0,0.00,100.00
1090529,709714,合晶統一9A購02,5000,5000,0,0.00,100.00
1090529,709715,宏捷科統一9A購01,5000,5000,0,0.00,100.00
1090529,709716,泰博統一9A購01,5000,5000,0,0.00,100.00
1090529,709717,神盾統一9A購01,5000,5000,0,0.00,100.00
1090529,709718,雙鴻統一9A購01,5000,5000,0,0.00,100.00
1090529,709719,宏捷科日盛99購01,10000,10000,0,0.00,100.00
1090529,709720,VHQ凱基9A購01,500,500,0,0.00,100.00
1090529,709721,三貝德凱基9A購01,500,500,0,0.00,100.00
1090529,709722,太景*凱基99購01,500,500,0,0.00,100.00
1090529,709723,宏捷科凱基99購01,500,500,0,0.00,100.00
1090529,709724,晶焱凱基99購01,500,500,0,0.00,100.00
1090529,709725,大學光永豐99購01,1000,1500,-500,-33.33,100.00
1090529,709726,宏捷科永豐99購01,4000,4000,0,0.00,100.00
1090529,709727,信驊永豐99購01,500,2000,-1500,-75.00,100.00
1090529,709728,威剛永豐99購02,3000,3000,0,0.00,100.00
1090529,709729,環球晶永豐99購01,1000,1000,0,0.00,100.00
1090529,709730,宏捷科康和99購01,5000,5000,0,0.00,100.00
1090529,709731,宏捷科群益99購01,1400,1400,0,0.00,100.00
1090529,709732,宏捷科元富99購01,5000,5000,0,0.00,100.00
1090529,709733,智擎元富99購01,3500,3500,0,0.00,100.00
1090529,709734,中美晶統一9B購02,14000,14000,0,0.00,100.00
1090529,709735,宏捷科統一9B購01,5000,5000,0,0.00,100.00
1090529,709736,宏捷科凱基9B購01,500,500,0,0.00,100.00
1090529,709737,威剛凱基9B購01,650,650,0,0.00,100.00
1090529,709738,建榮凱基9A購02,500,500,0,0.00,100.00
1090529,709739,神盾凱基9A購01,500,500,0,0.00,100.00
1090529,709740,新鉅科凱基99購01,5977,5977,0,0.00,100.00
1090529,709741,聚積凱基9A購01,500,500,0,0.00,100.00
1090529,709742,久元元大99購01,1500,1500,0,0.00,100.00
1090529,709743,久元元大99購02,2000,2000,0,0.00,100.00
1090529,709744,光頡元大99購01,8000,8000,0,0.00,100.00
1090529,709745,合晶元大99購02,1000,1000,0,0.00,100.00
1090529,709746,宏捷科元大99購03,5000,5000,0,0.00,100.00
1090529,709747,迅得元大9B購01,1000,1000,0,0.00,100.00
1090529,709748,勝麗元大99購01,1000,1000,0,0.00,100.00
1090529,709749,宏捷科群益99購02,2000,2000,0,0.00,100.00
1090529,709750,信昌電群益99購01,1300,1300,0,0.00,100.00
1090529,709751,安勤國票99購01,800,800,0,0.00,100.00
1090529,709752,中美晶富邦9B購01,10000,10000,0,0.00,100.00
1090529,709753,宏捷科富邦9B購01,10000,10000,0,0.00,100.00
1090529,709754,穩懋富邦9B購01,15000,15000,0,0.00,100.00
1090529,709755,力致永豐99購02,3000,3000,0,0.00,100.00
1090529,709756,大學光永豐99購02,1500,2000,-500,-25.00,100.00
1090529,709757,宏捷科永豐99購02,10000,10000,0,0.00,100.00
1090529,709758,精華永豐99購01,1000,1000,0,0.00,100.00
1090529,709759,鈺太永豐99購01,2000,2000,0,0.00,100.00
1090529,709760,合晶凱基9A購01,500,500,0,0.00,100.00
1090529,709761,雙鴻凱基9A購01,677,677,0,0.00,100.00
1090529,709762,宏捷科統一9B購02,5000,5000,0,0.00,100.00
1090529,709763,宣德統一99購01,5000,5000,0,0.00,100.00
1090529,709764,建榮統一9B購01,5000,5000,0,0.00,100.00
1090529,709765,海韻電永豐99購01,3000,3000,0,0.00,100.00
1090529,709766,優群永豐99購01,500,500,0,0.00,100.00
1090529,709767,穩懋永豐9A購01,2000,2000,0,0.00,100.00
1090529,709768,海韻電元富99購01,5000,5000,0,0.00,100.00
1090529,709769,宏捷科國票99購02,800,800,0,0.00,100.00
1090529,709770,威剛國票9A購01,1000,1000,0,0.00,100.00
1090529,709771,宏捷科元大99購04,5000,5000,0,0.00,100.00
1090529,709772,穩懋元大99購03,5000,5000,0,0.00,100.00
1090529,709773,宏捷科國泰9A購01,500,500,0,0.00,100.00
1090529,709774,海韻電國泰9B購01,2000,2000,0,0.00,100.00
1090529,709775,原相富邦9B購01,1000,1000,0,0.00,100.00
1090529,709776,環球晶富邦9B購02,10000,10000,0,0.00,100.00
1090529,709777,神盾群益9B購01,2400,2400,0,0.00,100.00
1090529,709778,波若威永豐99購02,1500,1500,0,0.00,100.00
1090529,709779,信昌電永豐99購01,1000,1000,0,0.00,100.00
1090529,709780,晶焱永豐99購01,1500,1500,0,0.00,100.00
1090529,709781,緯軟永豐99購01,1000,1000,0,0.00,100.00
1090529,709782,雙鴻永豐99購02,5000,5000,0,0.00,100.00
1090529,709783,宏捷科元富9C購01,5000,5000,0,0.00,100.00
1090529,709784,閎康中信99購01,5000,5000,0,0.00,100.00
1090529,709785,合晶凱基9A購02,500,500,0,0.00,100.00
1090529,709786,金居凱基99購01,500,500,0,0.00,100.00
1090529,709787,金居凱基9A購01,500,500,0,0.00,100.00
1090529,709788,泰博凱基9A購01,500,500,0,0.00,100.00
1090529,709789,神盾凱基99購02,500,500,0,0.00,100.00
1090529,709790,網龍凱基9A購01,500,500,0,0.00,100.00
1090529,709791,雙鴻凱基99購01,5500,5500,0,0.00,100.00
1090529,709792,穩懋凱基99購03,500,500,0,0.00,100.00
1090529,709793,威剛統一9B購01,5000,5000,0,0.00,100.00
1090529,709794,原相統一9B購01,5000,5000,0,0.00,100.00
1090529,709795,穩懋統一9B購01,15000,15000,0,0.00,100.00
1090529,709796,三貝德國票9A購01,5000,5000,0,0.00,100.00
1090529,709797,群聯國票9A購01,500,500,0,0.00,100.00
1090529,709798,優群國票9A購01,500,500,0,0.00,100.00
1090529,709799,鈺太國泰9C購01,4000,4000,0,0.00,100.00
1090529,709800,建榮富邦9B購01,10000,10000,0,0.00,100.00
1090529,709801,凡甲兆豐99購01,5000,5000,0,0.00,100.00
1090529,709802,中美晶兆豐9A購01,5000,5000,0,0.00,100.00
1090529,709803,穩懋兆豐99購02,5000,5000,0,0.00,100.00
1090529,709804,譜瑞兆豐99購01,5000,5000,0,0.00,100.00
1090529,709805,VHQ群益9B購01,5000,5000,0,0.00,100.00
1090529,709806,建榮群益9B購01,1400,1400,0,0.00,100.00
1090529,709807,博智群益99購01,5000,5000,0,0.00,100.00
1090529,709808,聚積群益99購01,1300,1300,0,0.00,100.00
1090529,709809,力致元大9A購01,500,500,0,0.00,100.00
1090529,709810,大宇資元大99購01,1000,1000,0,0.00,100.00
1090529,709811,大江元大99購03,1000,1000,0,0.00,100.00
1090529,709812,光頡元大99購02,10000,10000,0,0.00,100.00
1090529,709813,迅得元大99購02,1000,1000,0,0.00,100.00
1090529,709814,建榮元大99購01,5000,5000,0,0.00,100.00
1090529,709815,網龍元大9A購01,1000,1000,0,0.00,100.00
1090529,709816,環宇元大99購01,1000,1000,0,0.00,100.00
1090529,709817,網家群益99購01,1500,1500,0,0.00,100.00
1090529,709818,安勤永豐9A購01,1500,1500,0,0.00,100.00
1090529,709819,宏捷科永豐99購03,5000,5000,0,0.00,100.00
1090529,709820,迅得永豐99購01,3000,3000,0,0.00,100.00
1090529,709821,宣德永豐99購01,1500,1500,0,0.00,100.00
1090529,709822,原相永豐9A購01,5000,5000,0,0.00,100.00
1090529,709823,博智永豐9A購01,4066,4066,0,0.00,100.00
1090529,709824,新普永豐99購01,1000,1000,0,0.00,100.00
1090529,709825,聖暉永豐99購01,1500,1500,0,0.00,100.00
1090529,709826,優群永豐9A購01,1520,1520,0,0.00,100.00
1090529,709827,穩懋永豐99購01,1000,1000,0,0.00,100.00
1090529,709828,信驊國票9A購01,500,500,0,0.00,100.00
1090529,709829,聖暉國票9A購01,500,500,0,0.00,100.00
1090529,709830,信驊國泰9B購01,5000,5000,0,0.00,100.00
1090529,709831,原相富邦9C購01,5000,5000,0,0.00,100.00
1090529,709832,宏捷科元富9C購02,5000,5000,0,0.00,100.00
1090529,709833,聖暉元富99購01,3500,3500,0,0.00,100.00
1090529,709834,建榮統一9B購02,5000,5000,0,0.00,100.00
1090529,709835,台半元大99購01,9000,9000,0,0.00,100.00
1090529,709836,金居元大99購03,1000,1000,0,0.00,100.00
1090529,709837,博智元大99購02,5000,5000,0,0.00,100.00
1090529,709838,網龍元大9A購02,1000,1000,0,0.00,100.00
1090529,709839,力旺凱基99購01,500,500,0,0.00,100.00
1090529,709840,合晶凱基9A購03,500,500,0,0.00,100.00
1090529,709841,聯亞凱基9A購01,500,500,0,0.00,100.00
1090529,709842,譜瑞凱基9A購02,500,500,0,0.00,100.00
1090529,709843,雙鴻中信9B購01,10000,10000,0,0.00,100.00
1090529,709844,宏捷科凱基9A購01,500,500,0,0.00,100.00
1090529,709845,金可凱基9A購01,500,500,0,0.00,100.00
1090529,709846,凡甲元大99購01,5000,5000,0,0.00,100.00
1090529,709847,宇峻元大9C購01,1000,1000,0,0.00,100.00
1090529,709848,金可元大99購01,10000,10000,0,0.00,100.00
1090529,709849,保瑞元大9A購01,1000,1000,0,0.00,100.00
1090529,709850,建榮元大99購02,9000,9000,0,0.00,100.00
1090529,709851,晶焱元大9A購01,1000,1000,0,0.00,100.00
1090529,709852,群聯元大99購04,500,500,0,0.00,100.00
1090529,709853,大江國票9A購01,2000,2000,0,0.00,100.00
1090529,709854,穩懋國票99購02,500,500,0,0.00,100.00
1090529,709855,穩懋富邦9B購02,20000,20000,0,0.00,100.00
1090529,709856,晶焱兆豐9A購01,5000,5000,0,0.00,100.00
1090529,709857,環球晶兆豐99購01,5000,5000,0,0.00,100.00
1090529,709858,穩懋兆豐9A購01,5000,5000,0,0.00,100.00
1090529,709859,安勤群益99購01,1400,1400,0,0.00,100.00
1090529,709860,新鉅科群益9A購01,2000,2000,0,0.00,100.00
1090529,709861,環球晶群益99購01,1600,1600,0,0.00,100.00
1090529,709862,碩禾永豐99購01,2000,2000,0,0.00,100.00
1090529,709863,網龍永豐9A購01,1500,1500,0,0.00,100.00
1090529,709864,璟德元富99購01,4000,4000,0,0.00,100.00
1090529,709865,鈺太元富99購01,3500,3500,0,0.00,100.00
1090529,709866,凡甲永豐9A購01,3000,3000,0,0.00,100.00
1090529,709867,兆利永豐99購01,2000,2000,0,0.00,100.00
1090529,709868,欣銓永豐99購01,3000,3000,0,0.00,100.00
1090529,709869,信驊永豐99購02,2000,3500,-1500,-42.85,100.00
1090529,709870,群聯永豐99購01,1000,1000,0,0.00,100.00
1090529,709871,聚積永豐99購01,2000,2000,0,0.00,100.00
1090529,709872,環球晶永豐99購02,1000,1000,0,0.00,100.00
1090529,709873,東洋統一9B購01,8000,8000,0,0.00,100.00
1090529,709874,建榮凱基9A購03,500,500,0,0.00,100.00
1090529,709875,大中國票9A購01,3000,3000,0,0.00,100.00
1090529,709876,台燿國票9A購01,500,500,0,0.00,100.00
1090529,709877,泰博國泰9A購01,5000,5000,0,0.00,100.00
1090529,709878,大江元大99購04,1200,1500,-300,-20.00,100.00
1090529,709879,安勤元大99購02,1200,1200,0,0.00,100.00
1090529,709880,宏捷科元大99購06,1000,1000,0,0.00,100.00
1090529,709881,聖暉元大99購01,1500,1500,0,0.00,100.00
1090529,709882,優群元大99購03,1500,1500,0,0.00,100.00
1090529,709883,優群元大9B購01,1500,1500,0,0.00,100.00
1090529,709884,穩懋元大99購05,5000,5000,0,0.00,100.00
1090529,709885,信驊兆豐99購01,5000,5000,0,0.00,100.00
1090529,709886,中美晶群益9A購01,1600,1600,0,0.00,100.00
1090529,709887,神盾群益9B購02,5000,5000,0,0.00,100.00
1090529,709888,聯亞群益99購01,1600,1600,0,0.00,100.00
1090529,709889,台燿元富9C購01,5000,5000,0,0.00,100.00
1090529,709890,原相統一9A購01,5000,5000,0,0.00,100.00
1090529,709891,大宇資凱基9B購01,500,500,0,0.00,100.00
1090529,709892,宇峻凱基9B購01,5000,5000,0,0.00,100.00
1090529,709893,信驊凱基9A購01,2500,2600,-100,-3.84,100.00
1090529,709894,統新凱基9B購01,500,500,0,0.00,100.00
1090529,709895,順達凱基99購01,2500,2600,-100,-3.84,100.00
1090529,709896,雙美凱基9B購01,500,500,0,0.00,100.00
1090529,709897,雙鴻元大99購06,1000,1000,0,0.00,100.00
1090529,709898,穩懋元大99購06,5000,5000,0,0.00,100.00
1090529,709899,穩懋元大99購07,1500,1500,0,0.00,100.00
1090529,709900,力致永豐99購03,4500,5000,-500,-10.00,100.00
1090529,709901,光頡永豐99購01,4500,5000,-500,-10.00,100.00
1090529,709902,新鉅科永豐99購01,3000,3000,0,0.00,100.00
1090529,709903,精測永豐9A購01,2000,2000,0,0.00,100.00
1090529,709904,璟德永豐99購01,1000,1000,0,0.00,100.00
1090529,709905,環球晶永豐99購03,1000,1000,0,0.00,100.00
1090529,709906,兆利國票99購01,800,800,0,0.00,100.00
1090529,709907,金居國票9A購01,500,500,0,0.00,100.00
1090529,709908,信驊國票9A購02,500,500,0,0.00,100.00
1090529,709909,兆利國泰9A購01,5000,5000,0,0.00,100.00
1090529,709910,宏捷科國泰9B購01,3000,3000,0,0.00,100.00
1090529,709911,精測國泰9C購01,500,500,0,0.00,100.00
1090529,709912,威剛富邦9C購01,5000,5000,0,0.00,100.00
1090529,709913,M31群益99購01,1700,1700,0,0.00,100.00
1090529,709914,中美晶群益9B購01,1300,1300,0,0.00,100.00
1090529,709915,台燿群益99購02,2500,2500,0,0.00,100.00
1090529,709916,合晶群益9A購01,1400,1400,0,0.00,100.00
1090529,709917,緯軟群益9A購01,1500,1500,0,0.00,100.00
1090529,709918,璟德群益99購01,1500,1500,0,0.00,100.00
1090529,709919,環球晶群益99購02,1300,1300,0,0.00,100.00
1090529,709920,原相日盛9B購01,10000,10000,0,0.00,100.00
1090529,709921,雍智國泰9C購01,4000,4000,0,0.00,100.00
1090529,709922,璟德國泰9A購01,3000,3000,0,0.00,100.00
1090529,709923,VHQ群益99購01,5000,5000,0,0.00,100.00
1090529,709924,中美晶群益99購03,1400,1400,0,0.00,100.00
1090529,709925,精測群益99購01,1400,1400,0,0.00,100.00
1090529,709926,精測富邦9A購01,10000,10000,0,0.00,100.00
1090529,709927,聯亞國票9A購01,500,600,-100,-16.66,100.00
1090529,709928,穩懋國票99購03,500,500,0,0.00,100.00
1090529,709929,大江永豐99購01,2000,2000,0,0.00,100.00
1090529,709930,精測永豐99購01,2000,2000,0,0.00,100.00
1090529,709931,建榮統一9B購03,5000,5000,0,0.00,100.00
1090529,709932,中美晶凱基99購07,2500,2500,0,0.00,100.00
1090529,709933,碩禾凱基9B購01,5500,5500,0,0.00,100.00
1090529,709934,精測元富99購02,5000,5000,0,0.00,100.00
1090529,709935,鈺太元富99購02,5000,5000,0,0.00,100.00
1090529,709936,元太元大99購01,8000,8000,0,0.00,100.00
1090529,709937,兆利元大9B購01,1000,1000,0,0.00,100.00
1090529,709938,宏捷科元大99購07,1000,1000,0,0.00,100.00
1090529,709939,良維元大99購01,1500,1500,0,0.00,100.00
1090529,709940,信驊元大99購01,5000,5000,0,0.00,100.00
1090529,709941,信驊元大99購02,5000,5000,0,0.00,100.00
1090529,709942,威剛元大9A購02,5000,5000,0,0.00,100.00
1090529,709943,泰博元大99購01,1500,1500,0,0.00,100.00
1090529,709944,順達元大99購01,1500,1500,0,0.00,100.00
1090529,709945,群聯元大99購05,500,500,0,0.00,100.00
1090529,709946,精華元大99購01,2500,2500,0,0.00,100.00
1090529,709947,神盾永豐99購02,5000,5000,0,0.00,100.00
1090529,709948,穩懋永豐99購02,2000,2000,0,0.00,100.00
1090529,709949,中美晶日盛99購01,10000,10000,0,0.00,100.00
1090529,709950,大學光元大99購02,500,500,0,0.00,100.00
1090529,709951,台燿元大99購01,14000,14000,0,0.00,100.00
1090529,709952,良維元大99購02,1000,1000,0,0.00,100.00
1090529,709953,建榮元大9B購01,500,500,0,0.00,100.00
1090529,709954,M31國票9A購01,800,1000,-200,-20.00,100.00
1090529,709955,大江國票9A購02,500,500,0,0.00,100.00
1090529,709956,群聯統一9B購01,10000,10000,0,0.00,100.00
1090529,709957,璟德兆豐99購02,5000,5000,0,0.00,100.00
1090529,709958,迅得凱基99購01,5000,5000,0,0.00,100.00
1090529,709959,保瑞凱基9B購01,5000,5000,0,0.00,100.00
1090529,709960,原相凱基9A購01,500,500,0,0.00,100.00
1090529,709961,雍智凱基9B購01,1394,1394,0,0.00,100.00
1090529,709962,精測凱基99購03,5000,5000,0,0.00,100.00
1090529,709963,廣明凱基99購02,2500,2600,-100,-3.84,100.00
1090529,709964,璟德凱基99購01,2500,2600,-100,-3.84,100.00
1090529,709965,環球晶凱基99購07,2500,2700,-200,-7.40,100.00
1090529,709966,金居群益9B購01,1500,1500,0,0.00,100.00
1090529,709967,信驊群益99購01,1700,1700,0,0.00,100.00
1090529,709968,聯亞群益99購02,1600,1600,0,0.00,100.00
1090529,709969,譜瑞兆豐99購02,5000,5000,0,0.00,100.00
1090529,709970,宏捷科元大9A購01,1500,1500,0,0.00,100.00
1090529,709971,邦特元大99購01,15000,15000,0,0.00,100.00
1090529,709972,旺矽元大9B購01,1000,1000,0,0.00,100.00
1090529,709973,中美晶國票9A購01,500,500,0,0.00,100.00
1090529,709974,旺矽國票99購02,500,500,0,0.00,100.00
1090529,709975,宣德國票9A購01,2000,2000,0,0.00,100.00
1090529,709976,鈺太國票9A購01,700,800,-100,-12.50,100.00
1090529,709977,M31永豐99購02,1000,2000,-1000,-50.00,100.00
1090529,709978,建榮永豐9A購02,4000,5000,-1000,-20.00,100.00
1090529,709979,晶焱永豐9A購01,2500,2500,0,0.00,100.00
1090529,709980,鈊象永豐9A購01,5000,5000,0,0.00,100.00
1090529,709981,M31凱基99購02,2500,2700,-200,-7.40,100.00
1090529,709982,穩懋凱基99購05,2500,2600,-100,-3.84,100.00
1090529,709983,群聯日盛9B購01,10000,10000,0,0.00,100.00
1090529,709984,原相群益9C購01,1000,1000,0,0.00,100.00
1090529,709985,大江富邦9B購02,10000,10000,0,0.00,100.00
1090529,709986,金可中信99購01,5000,5000,0,0.00,100.00
1090529,709987,精華中信99購01,5000,5000,0,0.00,100.00
1090529,709988,大江永豐99購02,2000,2000,0,0.00,100.00
1090529,709989,茂達永豐99購01,2000,2000,0,0.00,100.00
1090529,709990,精測永豐99購02,2000,2000,0,0.00,100.00
1090529,709991,環球晶凱基99購08,2500,2600,-100,-3.84,100.00
1090529,709992,中美晶元大99購04,1000,1000,0,0.00,100.00
1090529,709993,中美晶元大99購05,1000,1000,0,0.00,100.00
1090529,709994,中美晶元大9B購01,2200,2200,0,0.00,100.00
1090529,709995,環球晶元大99購03,1000,1000,0,0.00,100.00
1090529,709996,環球晶元大99購04,5000,5000,0,0.00,100.00
1090529,709997,聯亞元大99購02,500,500,0,0.00,100.00
1090529,709998,穩懋元大99購09,500,500,0,0.00,100.00
1090529,709999,穩懋元大99購10,1000,1000,0,0.00,100.00
1090529,710000,穩懋元大99購11,1000,1000,0,0.00,100.00
1090529,710001,M31國票9A購02,500,500,0,0.00,100.00
1090529,710002,穩懋國票9A購01,500,500,0,0.00,100.00
1090529,710003,精測元大99購03,1500,1500,0,0.00,100.00
1090529,710004,中美晶元富9B購01,5000,5000,0,0.00,100.00
1090529,710005,中美晶元富9B購02,5000,5000,0,0.00,100.00
1090529,710006,神盾元富9B購01,5000,5000,0,0.00,100.00
1090529,710007,環球晶元富9B購01,5000,5000,0,0.00,100.00
1090529,710008,環球晶元富9B購02,5000,5000,0,0.00,100.00
1090529,710009,穩懋元富99購01,5000,5000,0,0.00,100.00
1090529,710010,中美晶國票9A購02,1000,1000,0,0.00,100.00
1090529,710011,泰博國票9A購01,500,500,0,0.00,100.00
1090529,710012,大宇資凱基9B購02,5000,5000,0,0.00,100.00
1090529,710013,金可凱基99購01,2500,2600,-100,-3.84,100.00
1090529,710014,信驊凱基99購01,1000,2600,-1600,-61.53,100.00
1090529,710015,統新凱基9A購01,5000,5000,0,0.00,100.00
1090529,710016,群聯凱基9A購01,5000,5000,0,0.00,100.00
1090529,710017,環球晶凱基99購09,2500,2600,-100,-3.84,100.00
1090529,710018,譜瑞凱基99購02,1000,2600,-1600,-61.53,100.00
1090529,710019,精測中信9A購01,5000,5000,0,0.00,100.00
1090529,710020,合晶永豐99購01,2000,2000,0,0.00,100.00
1090529,710021,雙鴻永豐99購03,5000,5000,0,0.00,100.00
1090529,710022,譜瑞永豐99購01,500,1000,-500,-50.00,100.00
1090529,710023,鈊象永豐99購03,5000,5000,0,0.00,100.00
1090529,710024,宏捷科永豐99購04,5000,5000,0,0.00,100.00
1090529,710025,泰博永豐99購02,1000,1000,0,0.00,100.00
1090529,710026,群聯永豐99購02,2000,2000,0,0.00,100.00
1090529,710027,優群永豐99購02,1000,1000,0,0.00,100.00
1090529,710028,原相群益9C購02,1500,1500,0,0.00,100.00
1090529,710029,優群群益9A購01,500,500,0,0.00,100.00
1090529,710030,大宇資元大9A購01,500,500,0,0.00,100.00
1090529,710031,金居元大99購04,500,500,0,0.00,100.00
1090529,710032,精測元大99購04,1500,1500,0,0.00,100.00
1090529,710033,聯亞元大9A購01,1000,1000,0,0.00,100.00
1090529,710034,穩懋元大9A購01,1000,1000,0,0.00,100.00
1090529,710035,雙鴻元富99購01,5000,5000,0,0.00,100.00
1090529,710036,大學光凱基9A購02,5000,5000,0,0.00,100.00
1090529,710037,群聯凱基99購03,5000,5000,0,0.00,100.00
1090529,710038,泰博群益9A購01,1600,1600,0,0.00,100.00
1090529,710039,宏捷科富邦9B購02,5000,5000,0,0.00,100.00
1090529,710040,穩懋亞東99購01,750,750,0,0.00,100.00
1090529,710041,原相凱基99購02,5000,5000,0,0.00,100.00
1090529,710042,群聯凱基99購04,5000,5000,0,0.00,100.00
1090529,710043,碩禾凱基9B購02,5000,5000,0,0.00,100.00
1090529,710044,雙美凱基99購03,5000,5000,0,0.00,100.00
1090529,710045,穩懋凱基99購06,2500,2600,-100,-3.84,100.00
1090529,710046,威剛元大9A購03,1000,1000,0,0.00,100.00
1090529,710047,群聯元大99購06,5000,5000,0,0.00,100.00
1090529,710048,環球晶元大99購05,5000,5000,0,0.00,100.00
1090529,710049,環球晶元大99購06,5000,5000,0,0.00,100.00
1090529,710050,中美晶永豐99購01,2500,2500,0,0.00,100.00
1090529,710051,宏捷科永豐99購05,5000,5000,0,0.00,100.00
1090529,710052,原相永豐99購03,4000,4000,0,0.00,100.00
1090529,710053,環球晶永豐99購04,1000,1000,0,0.00,100.00
1090529,710054,聯亞永豐99購01,1000,1000,0,0.00,100.00
1090529,710055,雙鴻永豐9A購01,5000,5000,0,0.00,100.00
1090529,710056,大江元大99購05,500,500,0,0.00,100.00
1090529,710057,M31永豐99購03,1000,2000,-1000,-50.00,100.00
1090529,710058,力致永豐9A購01,4500,5000,-500,-10.00,100.00
1090529,710059,大田永豐99購01,1500,1500,0,0.00,100.00
1090529,710060,光頡永豐99購02,4500,5000,-500,-10.00,100.00
1090529,710061,迅得永豐99購02,4500,5000,-500,-10.00,100.00
1090529,710062,原相永豐99購04,4000,4000,0,0.00,100.00
1090529,710063,神盾永豐99購03,5000,5000,0,0.00,100.00
1090529,710064,聚積永豐99購02,1000,1000,0,0.00,100.00
1090529,710065,璟德永豐99購02,1000,1000,0,0.00,100.00
1090529,710066,宏捷科群益99購03,1500,1500,0,0.00,100.00
1090529,710067,原相群益9C購03,1500,1500,0,0.00,100.00
1090529,710068,威剛康和99購01,5000,5000,0,0.00,100.00
1090529,710069,大江凱基99購02,5000,5000,0,0.00,100.00
1090529,710070,中美晶凱基99購08,2500,2600,-100,-3.84,100.00
1090529,710071,原相凱基99購03,5000,5000,0,0.00,100.00
1090529,710072,環球晶凱基99購11,2500,2900,-400,-13.79,100.00
1090529,710073,穩懋兆豐9A購02,5000,5000,0,0.00,100.00
1090529,710074,群聯元富99購01,5000,5000,0,0.00,100.00
1090529,710075,大江富邦9B購03,10000,10000,0,0.00,100.00
1090529,710076,穩懋富邦9B購03,10000,10000,0,0.00,100.00
1090529,710077,中美晶元大9A購01,1200,1200,0,0.00,100.00
1090529,710078,宇峻元大9A購01,500,500,0,0.00,100.00
1090529,710079,宣德元大9A購01,500,500,0,0.00,100.00
1090529,710080,環球晶元大99購09,6000,6000,0,0.00,100.00
1090529,710081,穩懋元大99購13,6000,6000,0,0.00,100.00
1090529,710082,穩懋元大99購14,8000,8000,0,0.00,100.00
1090529,710083,宏捷科凱基99購02,5000,5000,0,0.00,100.00
1090529,710084,泰博凱基99購02,5000,5000,0,0.00,100.00
1090529,710085,群聯凱基99購05,5000,5000,0,0.00,100.00
1090529,710086,穩懋凱基99購07,2500,2500,0,0.00,100.00
1090529,710087,大學光永豐99購03,500,1000,-500,-50.00,100.00
1090529,710088,威剛永豐99購03,2000,2000,0,0.00,100.00
1090529,710089,宣德永豐99購02,1500,1500,0,0.00,100.00
1090529,710090,碩禾永豐99購02,2036,2036,0,0.00,100.00
1090529,710091,優群元富99購01,5000,5000,0,0.00,100.00
1090529,710092,網家元大99購03,500,500,0,0.00,100.00
1090529,710093,聚積元大9C購01,1000,1000,0,0.00,100.00
1090529,710094,雙美元大9C購01,600,600,0,0.00,100.00
1090529,710095,穩懋元大99購15,5000,5000,0,0.00,100.00
1090529,710096,鈺太元大9A購01,500,500,0,0.00,100.00
1090529,710097,大學光群益9A購01,2300,2300,0,0.00,100.00
1090529,710098,尼克森永豐99購01,4500,5000,-500,-10.00,100.00
1090529,710099,亞泰永豐99購03,2000,2000,0,0.00,100.00
1090529,710100,旺矽永豐99購01,500,1000,-500,-50.00,100.00
1090529,710101,昇達科永豐99購01,1000,1000,0,0.00,100.00
1090529,710102,信昌電永豐99購02,1000,1000,0,0.00,100.00
1090529,710103,威剛永豐99購04,3000,3000,0,0.00,100.00
1090529,710104,新鉅科永豐99購02,1000,1000,0,0.00,100.00
1090529,710105,網龍永豐99購01,2206,2206,0,0.00,100.00
1090529,710106,廣明永豐99購01,1000,1000,0,0.00,100.00
1090529,710107,緯軟永豐99購02,1000,1000,0,0.00,100.00
1090529,710108,環宇永豐99購01,1500,1500,0,0.00,100.00
1090529,710109,晟德永豐99購01,1000,1000,0,0.00,100.00
1090529,710110,信昌電富邦9C購01,15000,15000,0,0.00,100.00
1090529,710111,三貝德凱基99購03,5000,5000,0,0.00,100.00
1090529,710112,大江凱基99購03,5000,5000,0,0.00,100.00
1090529,710113,宣德凱基99購01,5000,5000,0,0.00,100.00
1090529,710114,原相凱基99購04,5000,5000,0,0.00,100.00
1090529,710115,群聯凱基99購06,5000,5000,0,0.00,100.00
1090529,710116,環球晶凱基99購12,2600,2600,0,0.00,100.00
1090529,710117,聯亞凱基99購05,5000,5000,0,0.00,100.00
1090529,710118,雙鴻凱基99購02,5000,5000,0,0.00,100.00
1090529,710119,穩懋凱基99購08,2500,2600,-100,-3.84,100.00
1090529,710120,鈊象凱基99購02,5000,5000,0,0.00,100.00
1090529,710121,三貝德永豐99購02,4500,5000,-500,-10.00,100.00
1090529,710122,大江永豐99購03,1000,1000,0,0.00,100.00
1090529,710123,安勤永豐99購01,1500,1500,0,0.00,100.00
1090529,710124,良維永豐99購01,1000,1000,0,0.00,100.00
1090529,710125,金居永豐99購01,1000,1000,0,0.00,100.00
1090529,710126,南光永豐99購01,2000,2000,0,0.00,100.00
1090529,710127,原相永豐99購05,3500,3500,0,0.00,100.00
1090529,710128,晶焱永豐99購02,2000,2000,0,0.00,100.00
1090529,710129,群聯永豐99購03,2000,2000,0,0.00,100.00
1090529,710130,精測永豐99購03,2000,2000,0,0.00,100.00
1090529,710131,璟德永豐99購03,2000,2000,0,0.00,100.00
1090529,710132,鈊象永豐99購04,5000,5000,0,0.00,100.00
1090529,710133,宏捷科國泰9B購02,5000,5000,0,0.00,100.00
1090529,710134,環球晶國泰9A購03,5000,5000,0,0.00,100.00
1090529,710135,穩懋國泰9A購02,5000,5000,0,0.00,100.00
1090529,710136,大江元大9A購01,5000,5000,0,0.00,100.00
1090529,710137,原相元大9B購01,5000,5000,0,0.00,100.00
1090529,710138,群聯元大99購07,5000,5000,0,0.00,100.00
1090529,710139,環球晶元大99購10,5000,5000,0,0.00,100.00
1090529,710140,環球晶元大99購11,5000,5000,0,0.00,100.00
1090529,710141,聯亞元大99購03,1000,1000,0,0.00,100.00
1090529,710142,穩懋元大99購16,5000,5000,0,0.00,100.00
1090529,710143,譜瑞元大99購01,5000,5000,0,0.00,100.00
1090529,710144,鈊象元大9A購01,1500,1500,0,0.00,100.00
1090529,710145,原相台新99購02,5000,5000,0,0.00,100.00
1090529,710146,群聯台新99購01,5000,5000,0,0.00,100.00
1090529,710147,精測元富99購03,5000,5000,0,0.00,100.00
1090529,710148,精測元富99購04,5000,5000,0,0.00,100.00
1090529,710149,鈊象元富99購02,5000,5000,0,0.00,100.00
1090529,710150,M31凱基9A購01,1000,2600,-1600,-61.53,100.00
1090529,710151,VHQ凱基99購01,5000,5000,0,0.00,100.00
1090529,710152,中美晶凱基9A購03,2500,2600,-100,-3.84,100.00
1090529,710153,威剛凱基9A購03,5000,5000,0,0.00,100.00
1090529,710154,原相凱基9A購02,5000,5000,0,0.00,100.00
1090529,710155,群聯凱基9A購02,5000,5000,0,0.00,100.00
1090529,710156,精測凱基9A購01,5000,5000,0,0.00,100.00
1090529,710157,優群凱基9A購03,5000,5000,0,0.00,100.00
1090529,710158,環球晶凱基9A購01,2500,2700,-200,-7.40,100.00
1090529,710159,雙美凱基9A購01,5000,5000,0,0.00,100.00
1090529,710160,穩懋凱基9A購01,2500,2600,-100,-3.84,100.00
1090529,710161,鈊象凱基9A購02,5000,5000,0,0.00,100.00
1090529,710162,鈊象凱基9B購01,20000,20000,0,0.00,100.00
1090529,710163,鈺太國泰9B購01,5000,5000,0,0.00,100.00
1090529,710164,大江元大9A購02,5000,5000,0,0.00,100.00
1090529,710165,大學光元大9C購01,500,500,0,0.00,100.00
1090529,710166,中美晶元大9A購02,1000,1000,0,0.00,100.00
1090529,710167,宏捷科元大9B購01,1000,1000,0,0.00,100.00
1090529,710168,原相元大9A購04,5000,5000,0,0.00,100.00
1090529,710169,晶焱元大99購02,5000,5000,0,0.00,100.00
1090529,710170,聯亞元大99購04,1500,1500,0,0.00,100.00
1090529,710171,穩懋元大99購17,5000,5000,0,0.00,100.00
1090529,710172,穩懋元大99購18,6000,6000,0,0.00,100.00
1090529,710173,原相台新99購03,5000,5000,0,0.00,100.00
1090529,710174,群聯台新99購02,5000,5000,0,0.00,100.00
1090529,710175,伍豐永豐99購01,1000,1000,0,0.00,100.00
1090529,710176,兆利永豐99購02,1500,1500,0,0.00,100.00
1090529,710177,同亨永豐99購01,4500,5000,-500,-10.00,100.00
1090529,710178,合晶永豐99購02,2000,2000,0,0.00,100.00
1090529,710179,宜鼎永豐99購01,1000,1000,0,0.00,100.00
1090529,710180,信驊永豐99購04,4000,4000,0,0.00,100.00
1090529,710181,聯亞永豐99購02,1000,1000,0,0.00,100.00
1090529,710182,M31凱基99購03,1000,2800,-1800,-64.28,100.00
1090529,710183,中美晶凱基99購09,2500,2600,-100,-3.84,100.00
1090529,710184,雍智凱基99購02,5000,5000,0,0.00,100.00
1090529,710185,精測凱基99購04,5000,5000,0,0.00,100.00
1090529,710186,環球晶凱基99購13,2500,3300,-800,-24.24,100.00
1090529,710187,聯亞凱基99購06,5000,5000,0,0.00,100.00
1090529,710188,穩懋凱基99購09,2500,2800,-300,-10.71,100.00
1090529,710189,譜瑞凱基99購03,1000,2600,-1600,-61.53,100.00
1090529,710190,鈊象凱基99購03,15000,15000,0,0.00,100.00
1090529,710191,中美晶國票99購02,500,500,0,0.00,100.00
1090529,710192,穩懋國票99購04,500,500,0,0.00,100.00
1090529,710193,三貝德康和99購01,5000,5000,0,0.00,100.00
1090529,710194,優群康和99購01,5000,5000,0,0.00,100.00
1090529,710195,原相元富99購01,5000,5000,0,0.00,100.00
1090529,710196,穩懋元富99購02,5000,5000,0,0.00,100.00
1090529,710197,由田永豐99購01,4500,5000,-500,-10.00,100.00
1090529,710198,長科*永豐99購01,4500,5000,-500,-10.00,100.00
1090529,710199,皇田永豐99購01,2000,2000,0,0.00,100.00
1090529,710200,美琪瑪永豐99購01,4500,5000,-500,-10.00,100.00
1090529,710201,新揚科永豐99購01,4500,5000,-500,-10.00,100.00
1090529,710202,雍智永豐99購02,2000,3000,-1000,-33.33,100.00
1090529,710203,精華永豐99購02,1500,1500,0,0.00,100.00
1090529,710204,網家永豐99購01,500,1000,-500,-50.00,100.00
1090529,710205,網龍永豐99購02,2000,2000,0,0.00,100.00
1090529,710206,鈊象永豐99購05,5000,5000,0,0.00,100.00
1090529,710207,中美晶國泰9B購01,5000,5000,0,0.00,100.00
1090529,710208,群聯國泰9B購01,5000,5000,0,0.00,100.00
1090529,710209,群聯富邦9A購01,10000,10000,0,0.00,100.00
1090529,710210,環球晶富邦9B購03,10000,10000,0,0.00,100.00
1090529,710211,穩懋富邦9B購04,10000,10000,0,0.00,100.00
1090529,710212,群聯元大99購08,5000,5000,0,0.00,100.00
1090529,710213,鈊象元大99購06,5000,5000,0,0.00,100.00
1090529,710214,大江凱基99購04,5000,5000,0,0.00,100.00
1090529,710215,旺矽凱基99購01,1000,2600,-1600,-61.53,100.00
1090529,710216,泰博凱基99購03,5000,5000,0,0.00,100.00
1090529,710217,晶焱凱基99購02,2500,2800,-300,-10.71,100.00
1090529,710218,群聯凱基99購07,5000,5000,0,0.00,100.00
1090529,710219,精測凱基99購05,5000,5000,0,0.00,100.00
1090529,710220,鈊象凱基99購04,5000,5000,0,0.00,100.00
1090529,710221,原相國票99購03,1000,1000,0,0.00,100.00
1090529,710222,力麒康和99購01,5000,5000,0,0.00,100.00
1090529,710223,美琪瑪康和99購01,10000,10000,0,0.00,100.00
1090529,710224,新鉅科康和99購01,5000,5000,0,0.00,100.00
1090529,710225,聯亞康和99購01,5000,5000,0,0.00,100.00
1090529,710226,良維永豐99購02,1500,1500,0,0.00,100.00
1090529,710227,保瑞永豐99購01,2000,2000,0,0.00,100.00
1090529,710228,原相永豐99購06,5000,5000,0,0.00,100.00
1090529,710229,神盾永豐99購04,5000,5000,0,0.00,100.00
1090529,710230,神盾永豐99購05,5000,5000,0,0.00,100.00
1090529,710231,優群永豐99購03,2000,2000,0,0.00,100.00
1090529,710232,鈺太永豐99購02,2000,2000,0,0.00,100.00
1090529,710233,精測富邦9A購02,10000,10000,0,0.00,100.00
1090529,710234,台燿凱基99購01,2500,2600,-100,-3.84,100.00
1090529,710235,保瑞凱基99購01,5000,5000,0,0.00,100.00
1090529,710236,原相凱基99購05,5000,5000,0,0.00,100.00
1090529,710237,神盾凱基99購03,5000,5000,0,0.00,100.00
1090529,710238,精測凱基9A購02,5000,5000,0,0.00,100.00
1090529,710239,鈊象凱基99購05,5000,5000,0,0.00,100.00
1090529,710240,原相元大99購05,7000,7000,0,0.00,100.00
1090529,710241,神盾元大9A購04,5000,5000,0,0.00,100.00
1090529,710242,環球晶元大99購13,9000,9000,0,0.00,100.00
1090529,710243,穩懋元大99購20,10000,10000,0,0.00,100.00
1090529,710244,穩懋元大99購21,10000,10000,0,0.00,100.00
1090529,710245,中美晶群益99購04,2300,2300,0,0.00,100.00
1090529,710246,鈊象群益99購06,5000,5000,0,0.00,100.00
1090529,710247,信驊元富99購01,5000,5000,0,0.00,100.00
1090529,710248,原相元富99購02,5000,5000,0,0.00,100.00
1090529,710249,群聯元富99購02,5000,5000,0,0.00,100.00
1090529,710250,大江國票99購02,500,500,0,0.00,100.00
1090529,710251,泰博國票9A購02,500,500,0,0.00,100.00
1090529,710252,群聯國票99購02,4000,4000,0,0.00,100.00
1090529,710253,網龍康和99購01,10000,10000,0,0.00,100.00
1090529,710254,鈊象國泰9B購01,5000,5000,0,0.00,100.00
1090529,710255,中美晶富邦9B購03,10000,10000,0,0.00,100.00
1090529,710256,金居群益9B購02,2500,2500,0,0.00,100.00
1090529,710257,群聯群益99購02,500,500,0,0.00,100.00
1090529,710258,鈊象國票9B購01,1500,1500,0,0.00,100.00
1090529,710259,宇峻元大9B購01,1500,1500,0,0.00,100.00
1090529,710260,威剛元大9B購01,8000,8000,0,0.00,100.00
1090529,710261,神盾元大9B購01,500,500,0,0.00,100.00
1090529,710262,精測元大99購05,1500,1500,0,0.00,100.00
1090529,710263,環球晶元大99購14,1000,1000,0,0.00,100.00
1090529,710264,環球晶元大99購15,1000,1000,0,0.00,100.00
1090529,710265,穩懋元大99購22,6000,6000,0,0.00,100.00
1090529,710266,譜瑞元大99購02,1000,1000,0,0.00,100.00
1090529,710267,中美晶凱基9B購01,2500,2600,-100,-3.84,100.00
1090529,710268,世界凱基99購01,2500,2700,-200,-7.40,100.00
1090529,710269,建榮凱基99購01,1000,2500,-1500,-60.00,100.00
1090529,710270,碩禾凱基99購01,5000,5000,0,0.00,100.00
1090529,710271,精測凱基99購06,5000,5000,0,0.00,100.00
1090529,710272,環球晶凱基9B購01,2500,2900,-400,-13.79,100.00
1090529,710273,穩懋凱基99購10,2500,2900,-400,-13.79,100.00
1090529,710274,力致永豐99購04,4500,5000,-500,-10.00,100.00
1090529,710275,三貝德永豐99購03,4500,5000,-500,-10.00,100.00
1090529,710276,宏捷科永豐99購06,7362,7362,0,0.00,100.00
1090529,710277,杰力永豐99購01,4500,5000,-500,-10.00,100.00
1090529,710278,直得永豐99購01,1000,1000,0,0.00,100.00
1090529,710279,威剛永豐99購05,3500,3500,0,0.00,100.00
1090529,710280,新鉅科永豐99購03,2500,2500,0,0.00,100.00
1090529,710281,碩禾永豐99購03,2500,2500,0,0.00,100.00
1090529,710282,精測永豐99購04,3000,3000,0,0.00,100.00
1090529,710283,原相群益9A購01,3000,3000,0,0.00,100.00
1090529,710284,群聯群益9A購01,500,500,0,0.00,100.00
1090529,710285,大江富邦9C購01,10000,10000,0,0.00,100.00
1090529,710286,神盾元富9A購01,5000,5000,0,0.00,100.00
1090529,710287,群聯元富9A購01,5000,5000,0,0.00,100.00
1090529,710288,環球晶元富9A購01,5000,5000,0,0.00,100.00
1090529,710289,環球晶元富9A購02,5000,5000,0,0.00,100.00
1090529,710290,穩懋元富9A購01,5000,5000,0,0.00,100.00
1090529,710291,鈺太元富9A購01,5000,5000,0,0.00,100.00
1090529,710292,弘塑元大9B購01,8000,8000,0,0.00,100.00
1090529,710293,金可元大9A購01,1000,1000,0,0.00,100.00
1090529,710294,博智元大9A購01,8000,8000,0,0.00,100.00
1090529,710295,群聯元大9A購02,2000,2000,0,0.00,100.00
1090529,710296,雍智元大9B購01,500,500,0,0.00,100.00
1090529,710297,環球晶元大9A購02,1500,1500,0,0.00,100.00
1090529,710298,穩懋元大9A購02,8000,8000,0,0.00,100.00
1090529,710299,大中永豐9A購01,4500,5000,-500,-10.00,100.00
1090529,710300,尼克森永豐9A購01,4500,5000,-500,-10.00,100.00
1090529,710301,弘塑永豐9A購01,2000,2000,0,0.00,100.00
1090529,710302,均豪永豐9A購01,4500,5000,-500,-10.00,100.00
1090529,710303,迅得永豐9A購01,4500,5000,-500,-10.00,100.00
1090529,710304,波若威永豐9A購01,4500,5000,-500,-10.00,100.00
1090529,710305,前鼎永豐9A購01,4500,5000,-500,-10.00,100.00
1090529,710306,建榮永豐9B購01,3000,5000,-2000,-40.00,100.00
1090529,710307,泰博永豐9A購01,2000,2000,0,0.00,100.00
1090529,710308,神盾永豐9A購01,5000,5000,0,0.00,100.00
1090529,710309,高技永豐9A購01,5000,5000,0,0.00,100.00
1090529,710310,博智永豐9A購02,4000,4000,0,0.00,100.00
1090529,710311,群聯永豐9A購01,2000,2000,0,0.00,100.00
1090529,710312,鈊象永豐9A購02,5000,5000,0,0.00,100.00
1090529,710313,大中凱基9A購01,5000,5000,0,0.00,100.00
1090529,710314,弘塑凱基9A購01,2500,5000,-2500,-50.00,100.00
1090529,710315,良維凱基9A購01,2500,2600,-100,-3.84,100.00
1090529,710316,胡連凱基9A購01,1000,2600,-1600,-61.53,100.00
1090529,710317,群聯凱基9B購01,5000,5000,0,0.00,100.00
1090529,710318,環球晶凱基9A購02,2500,2600,-100,-3.84,100.00
1090529,710319,穩懋凱基9A購02,2500,2800,-300,-10.71,100.00
1090529,710320,鈊象國票9A購02,1000,1000,0,0.00,100.00
1090529,710321,弘塑康和9A購01,10000,10000,0,0.00,100.00
1090529,710322,昇達科康和9A購01,10000,10000,0,0.00,100.00
1090529,710323,緯軟康和9A購01,10000,10000,0,0.00,100.00
1090529,710324,環球晶台新9A購01,5000,5000,0,0.00,100.00
1090529,710325,三貝德國泰9C購01,5000,5000,0,0.00,100.00
1090529,710326,美琪瑪國泰9B購01,5000,5000,0,0.00,100.00
1090529,710327,譜瑞國泰9C購01,5000,5000,0,0.00,100.00
1090529,710328,精測台新9A購01,5000,5000,0,0.00,100.00
1090529,710329,M31元大9A購02,8000,8000,0,0.00,100.00
1090529,710330,元太元大9A購01,8000,8000,0,0.00,100.00
1090529,710331,世界元大9A購01,8000,8000,0,0.00,100.00
1090529,710332,良維元大9A購01,8000,8000,0,0.00,100.00
1090529,710333,信驊元大9A購01,6000,6000,0,0.00,100.00
1090529,710334,威剛元大9A購04,8000,8000,0,0.00,100.00
1090529,710335,精測元大9A購01,6000,6000,0,0.00,100.00
1090529,710336,頎邦元大9A購01,1500,1500,0,0.00,100.00
1090529,710337,杰力群益9C購01,5000,5000,0,0.00,100.00
1090529,710338,保瑞群益9B購01,5000,5000,0,0.00,100.00
1090529,710339,網龍群益9C購01,5000,5000,0,0.00,100.00
1090529,710340,兆利凱基9C購01,5000,5000,0,0.00,100.00
1090529,710341,威剛凱基9A購04,5000,5000,0,0.00,100.00
1090529,710342,泰博凱基9A購02,5000,5000,0,0.00,100.00
1090529,710343,網龍凱基9C購01,5000,5000,0,0.00,100.00
1090529,710344,聚積凱基9C購01,5000,5000,0,0.00,100.00
1090529,710345,穩懋麥證9A購01,10000,10000,0,0.00,100.00
1090529,710346,弘塑元富9A購01,5000,5000,0,0.00,100.00
1090529,710347,弘塑元富9A購02,5000,5000,0,0.00,100.00
1090529,710348,神盾元富9B購02,5000,5000,0,0.00,100.00
1090529,710349,精華元富9A購01,5000,5000,0,0.00,100.00
1090529,710350,宏捷科國票9A購02,500,500,0,0.00,100.00
1090529,710351,原相國票9B購01,1000,1000,0,0.00,100.00
1090529,710352,神盾國票9B購01,1000,1000,0,0.00,100.00
1090529,710353,神盾國票9C購01,2000,2000,0,0.00,100.00
1090529,710354,博智康和9A購01,5000,5000,0,0.00,100.00
1090529,710355,新普康和9A購01,10000,10000,0,0.00,100.00
1090529,710356,精測康和9A購01,10000,10000,0,0.00,100.00
1090529,710357,應華康和9A購01,10000,10000,0,0.00,100.00
1090529,710358,世禾永豐9A購01,4500,5000,-500,-10.00,100.00
1090529,710359,光隆永豐9A購01,4500,5000,-500,-10.00,100.00
1090529,710360,宇峻永豐9A購01,1500,1500,0,0.00,100.00
1090529,710361,佳邦永豐9A購01,1000,1000,0,0.00,100.00
1090529,710362,振曜永豐9A購01,4500,5000,-500,-10.00,100.00
1090529,710363,盛弘永豐9A購01,5000,5000,0,0.00,100.00
1090529,710364,新潤永豐9A購01,4500,5000,-500,-10.00,100.00
1090529,710365,是方國泰9B購01,5000,5000,0,0.00,100.00
1090529,710366,原相國泰9B購01,5000,5000,0,0.00,100.00
1090529,710367,建榮永豐9A購03,4000,5000,-1000,-20.00,100.00
1090529,710368,是方永豐9A購01,4000,4000,0,0.00,100.00
1090529,710369,森鉅永豐9A購01,2500,2500,0,0.00,100.00
1090529,710370,磐亞永豐9A購01,4000,4000,0,0.00,100.00
1090529,710371,寶雅永豐9A購01,2000,3000,-1000,-33.33,100.00
1090529,710372,原相群益9A購02,1000,1000,0,0.00,100.00
1090529,710373,精華元富9A購02,5000,5000,0,0.00,100.00
1090529,710374,譜瑞元富9A購01,5000,5000,0,0.00,100.00
1090529,710375,原相元大9B購02,8000,8000,0,0.00,100.00
1090529,710376,泰博元大9C購01,500,500,0,0.00,100.00
1090529,710377,新鉅科元大9B購01,8000,8000,0,0.00,100.00
1090529,710378,群聯元大9A購03,900,1200,-300,-25.00,100.00
1090529,710379,精測元大9A購02,8000,8000,0,0.00,100.00
1090529,710380,鈊象元大9A購02,5000,5000,0,0.00,100.00
1090529,710381,鈊象元大9B購01,5000,5000,0,0.00,100.00
1090529,710382,凡甲凱基9A購01,5000,5000,0,0.00,100.00
1090529,710383,凡甲凱基9A購02,5000,5000,0,0.00,100.00
1090529,710384,威剛凱基9B購02,5000,5000,0,0.00,100.00
1090529,710385,博智凱基9A購02,5000,5000,0,0.00,100.00
1090529,710386,大江國票9A購03,500,500,0,0.00,100.00
1090529,710387,穩懋國票9A購02,1000,1000,0,0.00,100.00
1090529,710388,鈊象國票9B購02,1000,1000,0,0.00,100.00
1090529,710389,原相台新9A購02,5000,5000,0,0.00,100.00
1090529,710390,M31群益9A購02,3000,3000,0,0.00,100.00
1090529,710391,原相元大9B購03,10000,10000,0,0.00,100.00
1090529,710392,精測元大9A購03,10000,10000,0,0.00,100.00
1090529,710393,雙鴻元大9C購01,6000,6000,0,0.00,100.00
1090529,710394,鈊象元大9C購01,5000,5000,0,0.00,100.00
1090529,710395,神盾富邦01購01,10000,10000,0,0.00,100.00
1090529,710396,雙鴻富邦9B購01,10000,10000,0,0.00,100.00
1090529,710397,群聯中信9C購01,5000,5000,0,0.00,100.00
1090529,710398,精測中信9A購02,5000,5000,0,0.00,100.00
1090529,710399,環球晶中信9A購02,5000,5000,0,0.00,100.00
1090529,710400,中美晶永豐9A購01,2000,2000,0,0.00,100.00
1090529,710401,建榮永豐9A購04,4000,5000,-1000,-20.00,100.00
1090529,710402,神盾永豐9A購02,5000,5000,0,0.00,100.00
1090529,710403,閎康永豐9A購01,2000,2000,0,0.00,100.00
1090529,710404,雙鴻永豐9A購02,5000,5000,0,0.00,100.00
1090529,710405,大學光凱基9A購03,5000,5000,0,0.00,100.00
1090529,710406,中美晶凱基9A購04,2500,2600,-100,-3.84,100.00
1090529,710407,泰博凱基9B購01,5000,5000,0,0.00,100.00
1090529,710408,博智凱基9B購01,5000,5000,0,0.00,100.00
1090529,710409,環球晶凱基9B購02,2500,2600,-100,-3.84,100.00
1090529,710410,雙鴻凱基9A購02,5000,5000,0,0.00,100.00
1090529,710411,穩懋凱基9B購01,2500,2800,-300,-10.71,100.00
1090529,710412,宇峻國票9B購01,1500,1500,0,0.00,100.00
1090529,710413,威剛中信9B購01,5000,5000,0,0.00,100.00
1090529,710414,雙鴻中信9A購01,10000,10000,0,0.00,100.00
1090529,710415,原相元大9A購05,5000,5000,0,0.00,100.00
1090529,710416,神盾元大9B購02,5000,5000,0,0.00,100.00
1090529,710417,博智元大9B購01,1500,1500,0,0.00,100.00
1090529,710418,群聯元大9A購05,1000,1000,0,0.00,100.00
1090529,710419,雙鴻元大9B購01,1100,5000,-3900,-78.00,100.00
1090529,710420,鈊象元大9B購02,5000,5000,0,0.00,100.00
1090529,710421,宏捷科永豐9A購01,5000,5000,0,0.00,100.00
1090529,710422,昇達科永豐9A購01,1500,1500,0,0.00,100.00
1090529,710423,晶焱永豐9A購02,2500,2500,0,0.00,100.00
1090529,710424,業強永豐9A購01,4500,5000,-500,-10.00,100.00
1090529,710425,頎邦永豐9A購01,2500,2500,0,0.00,100.00
1090529,710426,宏捷科凱基9A購02,5000,5000,0,0.00,100.00
1090529,710427,神盾凱基9B購02,5000,5000,0,0.00,100.00
1090529,710428,群聯凱基9B購02,5000,5000,0,0.00,100.00
1090529,710429,群聯麥證9B購01,10000,10000,0,0.00,100.00
1090529,710430,宏捷科國泰9B購03,5000,5000,0,0.00,100.00
1090529,710431,宇峻群益9B購01,3000,3000,0,0.00,100.00
1090529,710432,泰博群益9B購01,5000,5000,0,0.00,100.00
1090529,710433,原相富邦9C購02,10000,10000,0,0.00,100.00
1090529,710434,群聯富邦9B購01,10000,10000,0,0.00,100.00
1090529,710435,旺矽元富9A購01,5000,5000,0,0.00,100.00
1090529,710436,威剛元富9A購01,5000,5000,0,0.00,100.00
1090529,710437,威剛元富9A購02,5000,5000,0,0.00,100.00
1090529,710438,泰博元富9A購01,5000,5000,0,0.00,100.00
1090529,710439,泰博元富9A購02,5000,5000,0,0.00,100.00
1090529,710440,雙鴻元富9A購01,5000,5000,0,0.00,100.00
1090529,710441,鈊象元富9A購01,5000,5000,0,0.00,100.00
1090529,710442,鈊象元富9A購02,5000,5000,0,0.00,100.00
1090529,710443,威剛國泰9C購01,5000,5000,0,0.00,100.00
1090529,710444,雙鴻國泰9C購01,5000,5000,0,0.00,100.00
1090529,710445,博智群益9A購01,5000,5000,0,0.00,100.00
1090529,710446,神盾凱基9A購02,5000,5000,0,0.00,100.00
1090529,710447,群聯凱基9A購04,5000,5000,0,0.00,100.00
1090529,710448,優群凱基9A購04,5000,5000,0,0.00,100.00
1090529,710449,環球晶凱基9C購01,2500,2900,-400,-13.79,100.00
1090529,710450,雙鴻凱基9B購01,5000,5000,0,0.00,100.00
1090529,710451,穩懋凱基9C購01,2500,2900,-400,-13.79,100.00
1090529,710452,鈊象凱基9A購03,5000,5000,0,0.00,100.00
1090529,710453,鈊象第一9A購01,5000,5000,0,0.00,100.00
1090529,710454,精測中信9B購01,5000,5000,0,0.00,100.00
1090529,710455,鈊象中信9A購01,5000,5000,0,0.00,100.00
1090529,710456,台半永豐9A購01,2500,2500,0,0.00,100.00
1090529,710457,台燿永豐9A購01,2000,2000,0,0.00,100.00
1090529,710458,合晶永豐9A購01,2000,2000,0,0.00,100.00
1090529,710459,宜特永豐9A購01,2000,3000,-1000,-33.33,100.00
1090529,710460,旺矽永豐9A購01,2000,3000,-1000,-33.33,100.00
1090529,710461,信昌電永豐9A購01,2000,2000,0,0.00,100.00
1090529,710462,威剛永豐9A購01,4000,4000,0,0.00,100.00
1090529,710463,聚積永豐9A購01,2000,2000,0,0.00,100.00
1090529,710464,緯軟永豐9A購01,2000,2000,0,0.00,100.00
1090529,710465,優群永豐9A購02,3000,3000,0,0.00,100.00
1090529,710466,環宇永豐9A購01,2000,2000,0,0.00,100.00
1090529,710467,穩懋永豐9A購02,2500,2500,0,0.00,100.00
1090529,710468,鈊象永豐9A購03,5000,5000,0,0.00,100.00
1090529,710469,宏捷科元大9C購01,5000,5000,0,0.00,100.00
1090529,710470,信驊元大9A購02,10000,10000,0,0.00,100.00
1090529,710471,原相元大9B購04,5000,5000,0,0.00,100.00
1090529,710472,群聯元大9A購06,1100,1100,0,0.00,100.00
1090529,710473,精測元大9A購04,5000,5000,0,0.00,100.00
1090529,710474,環球晶富邦9C購01,20000,20000,0,0.00,100.00
1090529,710475,聯亞富邦9B購02,20000,20000,0,0.00,100.00
1090529,710476,鈊象富邦9B購01,10000,10000,0,0.00,100.00
1090529,710477,弘塑元大9A購01,8000,8000,0,0.00,100.00
1090529,710478,神盾元大9A購05,5000,5000,0,0.00,100.00
1090529,710479,群聯元大9A購07,6000,6000,0,0.00,100.00
1090529,710480,鈊象元大9B購03,6000,6000,0,0.00,100.00
1090529,710481,精測國泰9B購01,5000,5000,0,0.00,100.00
1090529,710482,威剛群益9A購03,3000,3000,0,0.00,100.00
1090529,710483,雙鴻群益9A購01,3000,3000,0,0.00,100.00
1090529,710484,鈊象群益9A購01,5000,5000,0,0.00,100.00
1090529,710485,譜瑞富邦9C購01,10000,10000,0,0.00,100.00
1090529,710486,大江第一9A購01,5000,5000,0,0.00,100.00
1090529,710487,環球晶第一9A購01,20000,20000,0,0.00,100.00
1090529,710488,穩懋第一9A購01,5000,5000,0,0.00,100.00
1090529,710489,力旺永豐9A購01,1000,2000,-1000,-50.00,100.00
1090529,710490,世界永豐9A購01,1500,1500,0,0.00,100.00
1090529,710491,宇峻永豐9A購02,2000,2000,0,0.00,100.00
1090529,710492,建榮永豐9B購02,5000,5000,0,0.00,100.00
1090529,710493,原相永豐9A購02,5000,5000,0,0.00,100.00
1090529,710494,博智國票9A購01,1500,1500,0,0.00,100.00
1090529,710495,威剛統一9C購01,5000,5000,0,0.00,100.00
1090529,710496,穩懋統一9C購01,20000,20000,0,0.00,100.00
1090529,710497,網家麥證9A購01,12000,12000,0,0.00,100.00
1090529,710498,建榮凱基9C購01,2500,2600,-100,-3.84,100.00
1090529,710499,網家國泰9B購01,5000,5000,0,0.00,100.00
1090529,710500,弘塑群益9A購01,5000,5000,0,0.00,100.00
1090529,710501,威剛元大9A購05,8000,8000,0,0.00,100.00
1090529,710502,泰博元大9B購01,500,500,0,0.00,100.00
1090529,710503,雙鴻元大9C購02,2300,5000,-2700,-54.00,100.00
1090529,710504,世界富邦9C購01,10000,10000,0,0.00,100.00
1090529,710505,泰博富邦9B購01,10000,10000,0,0.00,100.00
1090529,710506,頎邦富邦9C購01,10000,10000,0,0.00,100.00
1090529,710507,宏捷科凱基9C購01,5000,5000,0,0.00,100.00
1090529,710508,南光凱基9A購01,2500,3000,-500,-16.66,100.00
1090529,710509,建榮凱基9B購01,1000,2500,-1500,-60.00,100.00
1090529,710510,群聯凱基9B購03,5000,5000,0,0.00,100.00
1090529,710511,網家凱基9A購01,5000,5000,0,0.00,100.00
1090529,710512,中美晶統一9A購01,10000,10000,0,0.00,100.00
1090529,710513,雙鴻統一9C購01,5000,5000,0,0.00,100.00
1090529,710514,穩懋統一9A購02,10000,10000,0,0.00,100.00
1090529,710515,大學光永豐9A購02,3000,3000,0,0.00,100.00
1090529,710516,宇峻永豐9B購01,2500,2500,0,0.00,100.00
1090529,710517,保瑞永豐9A購01,4500,5000,-500,-10.00,100.00
1090529,710518,建榮永豐9A購05,5000,5000,0,0.00,100.00
1090529,710519,胡連永豐9A購01,2500,2500,0,0.00,100.00
1090529,710520,泰博永豐9A購02,4000,4000,0,0.00,100.00
1090529,710521,神盾永豐9A購03,5000,5000,0,0.00,100.00
1090529,710522,博智永豐9A購03,4000,4000,0,0.00,100.00
1090529,710523,網龍永豐9A購02,5000,5000,0,0.00,100.00
1090529,710524,大江國票9A購04,500,1000,-500,-50.00,100.00
1090529,710525,弘塑國票9A購01,600,1000,-400,-40.00,100.00
1090529,710526,網家國票9A購01,500,1000,-500,-50.00,100.00
1090529,710527,大江國泰9C購01,5000,5000,0,0.00,100.00
1090529,710528,雍智群益9A購01,3000,3000,0,0.00,100.00
1090529,710529,威剛元大9A購06,8000,8000,0,0.00,100.00
1090529,710530,泰博元大9A購01,10000,10000,0,0.00,100.00
1090529,710531,神盾元大9A購06,5000,5000,0,0.00,100.00
1090529,710532,群聯元大9A購08,1000,1300,-300,-23.07,100.00
1090529,710533,鈊象元大9B購04,5000,5000,0,0.00,100.00
1090529,710534,鈺太元大9B購01,10000,10000,0,0.00,100.00
1090529,710535,網家第一9A購01,5000,5000,0,0.00,100.00
1090529,710536,凡甲永豐9A購02,3000,3000,0,0.00,100.00
1090529,710537,金居永豐9A購01,2000,2000,0,0.00,100.00
1090529,710538,原相永豐9A購04,5000,5000,0,0.00,100.00
1090529,710539,華研永豐9A購01,3000,3000,0,0.00,100.00
1090529,710540,群聯永豐9A購02,2000,2000,0,0.00,100.00
1090529,710541,雍智永豐9A購01,4000,4000,0,0.00,100.00
1090529,710542,網家永豐9A購01,1000,1000,0,0.00,100.00
1090529,710543,網龍永豐9A購03,5000,5000,0,0.00,100.00
1090529,710544,鈺太永豐9A購01,4000,4000,0,0.00,100.00
1090529,710545,力旺凱基9A購01,1000,3100,-2100,-67.74,100.00
1090529,710546,宏捷科凱基9A購03,5000,5000,0,0.00,100.00
1090529,710547,原相凱基9A購03,5000,5000,0,0.00,100.00
1090529,710548,泰博凱基9A購03,5000,5000,0,0.00,100.00
1090529,710549,精華凱基9A購01,2500,2700,-200,-7.40,100.00
1090529,710550,網家凱基9C購01,5000,5000,0,0.00,100.00
1090529,710551,鈺太凱基9A購01,5000,5000,0,0.00,100.00
1090529,710552,泰博統一9C購01,10000,10000,0,0.00,100.00
1090529,710553,穩懋統一9B購03,5000,5000,0,0.00,100.00
1090529,710554,中美晶國票9A購04,1000,1000,0,0.00,100.00
1090529,710555,宇峻國票9A購01,1000,1000,0,0.00,100.00
1090529,710556,良維國票9A購01,700,1000,-300,-30.00,100.00
1090529,710557,優群國票9A購02,700,1000,-300,-30.00,100.00
1090529,710558,雙鴻國票9A購03,800,1000,-200,-20.00,100.00
1090529,710559,世界元大9A購03,6000,6000,0,0.00,100.00
1090529,710560,宏捷科元大9B購02,5000,5000,0,0.00,100.00
1090529,710561,威剛元大9B購02,5000,5000,0,0.00,100.00
1090529,710562,胡連元大9A購01,10000,10000,0,0.00,100.00
1090529,710563,原相元大9A購08,5000,5000,0,0.00,100.00
1090529,710564,群聯元大9A購09,1100,1100,0,0.00,100.00
1090529,710565,群聯元大9A購10,1400,1400,0,0.00,100.00
1090529,710566,碩禾元大9B購01,5000,5000,0,0.00,100.00
1090529,710567,優群元大9A購01,8000,8000,0,0.00,100.00
1090529,710568,鈊象兆豐9A購01,5000,5000,0,0.00,100.00
1090529,710569,中美晶富邦9B購04,10000,10000,0,0.00,100.00
1090529,710570,宏捷科群益9A購01,5000,5000,0,0.00,100.00
1090529,710571,新鉅科群益9A購02,5000,5000,0,0.00,100.00
1090529,710572,網家群益9A購01,5000,5000,0,0.00,100.00
1090529,710573,網龍群益9A購01,5000,5000,0,0.00,100.00
1090529,710574,鈊象群益9A購02,5000,5000,0,0.00,100.00
1090529,710575,環球晶中信9B購01,5000,5000,0,0.00,100.00
1090529,710576,M31永豐9A購01,3000,3000,0,0.00,100.00
1090529,710577,大江永豐9A購01,2000,2000,0,0.00,100.00
1090529,710578,世界永豐9A購02,1500,1500,0,0.00,100.00
1090529,710579,伍豐永豐9A購01,1500,1500,0,0.00,100.00
1090529,710580,兆利永豐9A購01,2000,2000,0,0.00,100.00
1090529,710581,欣銓永豐9A購01,4000,4000,0,0.00,100.00
1090529,710582,新鉅科永豐9A購01,2500,2500,0,0.00,100.00
1090529,710583,精測永豐9A購02,3000,3000,0,0.00,100.00
1090529,710584,網家永豐9A購02,1500,1500,0,0.00,100.00
1090529,710585,穩懋麥證9A購02,20000,20000,0,0.00,100.00
1090529,710586,原相統一9C購01,5000,5000,0,0.00,100.00
1090529,710587,宏捷科凱基9C購02,5000,5000,0,0.00,100.00
1090529,710588,信驊凱基9A購03,2500,2600,-100,-3.84,100.00
1090529,710589,威剛凱基9A購05,5000,5000,0,0.00,100.00
1090529,710590,鈺太凱基9B購01,5000,5000,0,0.00,100.00
1090529,710591,凡甲國票9A購01,800,1500,-700,-46.66,100.00
1090529,710592,大江國票9A購05,1000,1000,0,0.00,100.00
1090529,710593,弘塑國票9A購02,600,1000,-400,-40.00,100.00
1090529,710594,泰博國票9A購03,3000,5000,-2000,-40.00,100.00
1090529,710595,雍智國票9A購01,600,1000,-400,-40.00,100.00
1090529,710596,大江元大9A購03,1100,5000,-3900,-78.00,100.00
1090529,710597,大學光元大9A購01,1000,10000,-9000,-90.00,100.00
1090529,710598,原相元大9A購09,6000,6000,0,0.00,100.00
1090529,710599,泰博元大9A購02,10000,10000,0,0.00,100.00
1090529,710600,群聯元大9A購11,1100,5000,-3900,-78.00,100.00
1090529,710601,精測元大9A購05,5000,5000,0,0.00,100.00
1090529,710602,鈊象元大9A購04,5000,5000,0,0.00,100.00
1090529,710603,大江凱基9B購01,5000,5000,0,0.00,100.00
1090529,710604,大學光凱基9A購04,5000,5000,0,0.00,100.00
1090529,710605,原相凱基9B購01,5000,5000,0,0.00,100.00
1090529,710606,太醫統一9C購01,20000,20000,0,0.00,100.00
1090529,710607,寶雅統一9C購01,5000,5000,0,0.00,100.00
1090529,710608,鈊象統一9A購02,10000,10000,0,0.00,100.00
1090529,710609,鈊象統一9A購03,10000,10000,0,0.00,100.00
1090529,710610,凡甲兆豐9A購01,5000,5000,0,0.00,100.00
1090529,710611,泰博兆豐9A購01,5000,5000,0,0.00,100.00
1090529,710612,環球晶兆豐9B購01,5000,5000,0,0.00,100.00
1090529,710613,聯亞兆豐9A購01,5000,5000,0,0.00,100.00
1090529,710614,雙鴻兆豐9B購01,5000,5000,0,0.00,100.00
1090529,710615,穩懋兆豐9A購03,5000,5000,0,0.00,100.00
1090529,710616,穩懋兆豐9B購01,5000,5000,0,0.00,100.00
1090529,710617,大江永豐9A購02,2500,2500,0,0.00,100.00
1090529,710618,六角永豐9A購01,3000,3000,0,0.00,100.00
1090529,710619,太醫永豐9A購01,2500,2500,0,0.00,100.00
1090529,710620,信昌電永豐9A購02,2000,2000,0,0.00,100.00
1090529,710621,原相永豐9A購05,5000,5000,0,0.00,100.00
1090529,710622,雍智永豐9A購02,4000,4000,0,0.00,100.00
1090529,710623,碩禾永豐9A購01,3000,3000,0,0.00,100.00
1090529,710624,寶雅永豐9A購02,3000,3000,0,0.00,100.00
1090529,710625,大江國票9A購06,600,800,-200,-25.00,100.00
1090529,710626,弘塑國票9A購03,700,1000,-300,-30.00,100.00
1090529,710627,宏捷科國票9A購03,1500,2000,-500,-25.00,100.00
1090529,710628,鈊象國票9A購04,500,800,-300,-37.50,100.00
1090529,710629,凡甲群益9A購01,5000,5000,0,0.00,100.00
1090529,710630,大江群益9A購01,5000,5000,0,0.00,100.00
1090529,710631,宇峻群益9A購03,5000,5000,0,0.00,100.00
1090529,710632,群聯群益9A購02,5000,5000,0,0.00,100.00
1090529,710633,雙鴻群益9A購02,5000,5000,0,0.00,100.00
1090529,710634,鈊象群益9A購03,5000,5000,0,0.00,100.00
1090529,710635,鈺太群益9A購01,5000,5000,0,0.00,100.00
1090529,710636,寶雅凱基9A購01,2500,5000,-2500,-50.00,100.00
1090529,710637,原相統一9A購03,5000,5000,0,0.00,100.00
1090529,710638,精測統一9B購01,20000,20000,0,0.00,100.00
1090529,710639,穩懋統一9C購02,15000,15000,0,0.00,100.00
1090529,710640,大江元大9A購04,1100,5000,-3900,-78.00,100.00
1090529,710641,信驊元大9A購03,8000,8000,0,0.00,100.00
1090529,710642,原相元大9A購10,9000,9000,0,0.00,100.00
1090529,710643,泰博元大9B購02,10000,10000,0,0.00,100.00
1090529,710644,博智元大9A購02,10000,10000,0,0.00,100.00
1090529,710645,網家元大9A購01,5000,5000,0,0.00,100.00
1090529,710646,優群元大9A購02,10000,10000,0,0.00,100.00
1090529,710647,威剛富邦9B購01,6000,6000,0,0.00,100.00
1090529,710648,弘塑國泰9C購01,7800,7800,0,0.00,100.00
1090529,710649,神盾國泰9C購01,5000,5000,0,0.00,100.00
1090529,710650,新普國泰9C購01,5000,5000,0,0.00,100.00
1090529,710651,信驊群益9A購01,5000,5000,0,0.00,100.00
1090529,710652,原相中信03購01,5000,5000,0,0.00,100.00
1090529,710653,博智中信9A購01,5000,5000,0,0.00,100.00
1090529,710654,弘塑永豐9A購02,3000,4000,-1000,-25.00,100.00
1090529,710655,佳邦永豐9A購02,2000,2000,0,0.00,100.00
1090529,710656,博智永豐9A購04,4000,4000,0,0.00,100.00
1090529,710657,閎康永豐9A購02,2500,2500,0,0.00,100.00
1090529,710658,順達永豐9A購01,3000,5000,-2000,-40.00,100.00
1090529,710659,雍智永豐9A購03,3000,3000,0,0.00,100.00
1090529,710660,雙美永豐9A購01,5000,5000,0,0.00,100.00
1090529,710661,良維兆豐9B購01,5000,5000,0,0.00,100.00
1090529,710662,金居兆豐9A購01,5000,5000,0,0.00,100.00
1090529,710663,原相兆豐9B購01,5000,5000,0,0.00,100.00
1090529,710664,神盾兆豐9B購01,5000,5000,0,0.00,100.00
1090529,710665,新普兆豐9A購01,5000,5000,0,0.00,100.00
1090529,710666,凡甲元大9A購03,8000,8000,0,0.00,100.00
1090529,710667,泰博元大9A購03,5000,5000,0,0.00,100.00
1090529,710668,原相兆豐9B購02,5000,5000,0,0.00,100.00
1090529,710669,環球晶兆豐9B購02,5000,5000,0,0.00,100.00
1090529,710670,雙美群益9B購01,5000,5000,0,0.00,100.00
1090529,710671,大江富邦9C購02,10000,10000,0,0.00,100.00
1090529,710672,M31凱基9A購02,2500,5000,-2500,-50.00,100.00
1090529,710673,大江凱基9A購02,5000,5000,0,0.00,100.00
1090529,710674,原相凱基9A購06,5000,5000,0,0.00,100.00
1090529,710675,群聯凱基9B購04,5000,5000,0,0.00,100.00
1090529,710676,精測凱基9A購04,5000,5000,0,0.00,100.00
1090529,710677,聯亞凱基9A購02,5000,5000,0,0.00,100.00
1090529,710678,穩懋凱基9A購04,2500,5000,-2500,-50.00,100.00
1090529,710679,譜瑞凱基9A購03,2500,5000,-2500,-50.00,100.00
1090529,710680,雙鴻第一9B購01,5000,5000,0,0.00,100.00
1090529,710681,泰博中信9B購01,5000,5000,0,0.00,100.00
1090529,710682,精測中信9A購03,5000,5000,0,0.00,100.00
1090529,710683,弘塑永豐9A購03,3000,5000,-2000,-40.00,100.00
1090529,710684,旺矽永豐9A購02,3000,5000,-2000,-40.00,100.00
1090529,710685,業強永豐9A購02,4500,5000,-500,-10.00,100.00
1090529,710686,中美晶麥證9A購01,20000,20000,0,0.00,100.00
1090529,710687,威剛麥證9B購01,5000,5000,0,0.00,100.00
1090529,710688,博智統一9A購01,10000,10000,0,0.00,100.00
1090529,710689,博智統一9A購02,10000,10000,0,0.00,100.00
1090529,710690,環球晶統一9C購01,15000,15000,0,0.00,100.00
1090529,710691,群聯國泰9C購01,5000,5000,0,0.00,100.00
1090529,710692,精測國泰9C購02,5000,5000,0,0.00,100.00
1090529,710693,優群國泰9B購01,5000,5000,0,0.00,100.00
1090529,710694,晟德兆豐9B購01,5000,5000,0,0.00,100.00
1090529,710695,鈊象兆豐9B購01,5000,5000,0,0.00,100.00
1090529,710696,大江元大9A購05,1100,5000,-3900,-78.00,100.00
1090529,710697,信驊元大9A購05,10000,10000,0,0.00,100.00
1090529,710698,雍智元大9A購01,5000,5000,0,0.00,100.00
1090529,710699,優群元大9A購03,8000,8000,0,0.00,100.00
1090529,710700,雙美元大9A購01,1400,5000,-3600,-72.00,100.00
1090529,710701,鈊象元大9A購05,6000,6000,0,0.00,100.00
1090529,710702,鈺太元大9A購02,5000,5000,0,0.00,100.00
1090529,710703,信驊群益9A購02,5000,5000,0,0.00,100.00
1090529,710704,泰博群益9A購02,5000,5000,0,0.00,100.00
1090529,710705,精測群益9A購02,5000,5000,0,0.00,100.00
1090529,710706,精測永豐9A購03,2000,5000,-3000,-60.00,100.00
1090529,710707,璟德永豐9A購01,2000,5000,-3000,-60.00,100.00
1090529,710708,晟德永豐9A購01,1500,5000,-3500,-70.00,100.00
1090529,710709,頎邦永豐9A購02,2000,5000,-3000,-60.00,100.00
1090529,710710,群聯麥證9A購01,8000,8000,0,0.00,100.00
1090529,710711,穩懋統一9A購04,15000,15000,0,0.00,100.00
1090529,710712,M31凱基9A購03,2500,5000,-2500,-50.00,100.00
1090529,710713,弘塑凱基9B購01,5000,5000,0,0.00,100.00
1090529,710714,環球晶凱基9B購03,2500,5000,-2500,-50.00,100.00
1090529,710715,穩懋凱基9A購05,2500,5000,-2500,-50.00,100.00
1090529,710716,凡甲永豐9A購03,3000,5000,-2000,-40.00,100.00
1090529,710717,宏捷科永豐9B購01,5000,5000,0,0.00,100.00
1090529,710718,良維永豐9A購01,2000,5000,-3000,-60.00,100.00
1090529,710719,南光永豐9A購01,2500,5000,-2500,-50.00,100.00
1090529,710720,優群永豐9A購03,3000,5000,-2000,-40.00,100.00
1090529,710721,威剛統一9C購02,5000,5000,0,0.00,100.00
1090529,710722,宏捷科凱基9B購02,5000,5000,0,0.00,100.00
1090529,710723,原相凱基9B購02,5000,5000,0,0.00,100.00
1090529,710724,精測凱基9A購05,5000,5000,0,0.00,100.00
1090529,710725,優群凱基9B購01,5000,5000,0,0.00,100.00
1090529,710726,頎邦凱基9A購01,2500,5000,-2500,-50.00,100.00
1090529,710727,凡甲元大9B購01,5000,5000,0,0.00,100.00
1090529,710728,弘塑元大9B購02,5000,5000,0,0.00,100.00
1090529,710729,宏捷科元大9A購02,5000,5000,0,0.00,100.00
1090529,710730,威剛元大9B購03,5000,5000,0,0.00,100.00
1090529,710731,網龍元大9A購03,800,8000,-7200,-90.00,100.00
1090529,710732,雙鴻元大9C購03,1400,5000,-3600,-72.00,100.00
1090529,710733,鈊象元大9A購06,5000,5000,0,0.00,100.00
1090529,710734,精測兆豐9B購01,5000,5000,0,0.00,100.00
1090529,710735,鈺太兆豐9B購01,5000,5000,0,0.00,100.00
1090529,710736,宏捷科群益9A購02,5000,5000,0,0.00,100.00
1090529,710737,璟德群益9A購01,5000,5000,0,0.00,100.00
1090529,710738,宏捷科國票9A購04,1000,5000,-4000,-80.00,100.00
1090529,710739,南光國票9A購01,1000,5000,-4000,-80.00,100.00
1090529,710740,優群國票9A購03,1000,5000,-4000,-80.00,100.00
1090529,710741,雙美國票9A購01,5000,5000,0,0.00,100.00
1090529,710742,聯亞中信9A購01,5000,5000,0,0.00,100.00
1090529,710743,大學光元大9A購02,10000,10000,0,0.00,100.00
1090529,710744,太醫元大9A購01,15000,15000,0,0.00,100.00
1090529,710745,宏捷科元大9A購03,8000,8000,0,0.00,100.00
1090529,710746,良維元大9A購02,8000,8000,0,0.00,100.00
1090529,710747,信昌電元大9A購01,10000,10000,0,0.00,100.00
1090529,710748,是方元大9A購01,10000,10000,0,0.00,100.00
1090529,710749,順達元大9A購01,10000,10000,0,0.00,100.00
1090529,710750,群聯元大9B購01,5000,5000,0,0.00,100.00
1090529,710751,璟德元大9A購01,10000,10000,0,0.00,100.00
1090529,710752,鈊象元大9A購07,5000,5000,0,0.00,100.00
1090529,710753,鈺太元大9A購03,10000,10000,0,0.00,100.00
1090529,710754,精測富邦9B購01,10000,10000,0,0.00,100.00
1090529,710755,良維群益9A購01,5000,5000,0,0.00,100.00
1090529,710756,順達群益9B購01,5000,5000,0,0.00,100.00
1090529,710757,頎邦群益9B購01,5000,5000,0,0.00,100.00
1090529,710758,凡甲國票9A購02,1500,5000,-3500,-70.00,100.00
1090529,710759,優群國票9A購04,1000,5000,-4000,-80.00,100.00
1090529,710760,頎邦國票9A購01,1000,5000,-4000,-80.00,100.00
1090529,710761,穩懋中信9A購01,5000,5000,0,0.00,100.00
1090529,710762,穩懋中信9C購01,5000,5000,0,0.00,100.00
1090529,710763,頎邦中信9A購01,5000,5000,0,0.00,100.00
1090529,710764,良維凱基9B購01,5000,5000,0,0.00,100.00
1090529,710765,大學光永豐9A購03,3000,5000,-2000,-40.00,100.00
1090529,710766,泰博永豐9A購03,5000,5000,0,0.00,100.00
1090529,710767,雙鴻永豐9B購01,5000,5000,0,0.00,100.00
1090529,710768,中美晶統一9C購01,15000,15000,0,0.00,100.00
1090529,710769,宏捷科統一9C購01,15000,15000,0,0.00,100.00
1090529,710770,中美晶兆豐9B購01,5000,5000,0,0.00,100.00
1090529,710771,金可兆豐9A購01,5000,5000,0,0.00,100.00
1090529,710772,穩懋兆豐9B購02,5000,5000,0,0.00,100.00
1090529,710773,大學光元大9A購03,5000,5000,0,0.00,100.00
1090529,710774,新普元大9A購02,10000,10000,0,0.00,100.00
1090529,710775,雍智元大9A購02,5000,5000,0,0.00,100.00
1090529,710776,精華元大9A購01,10000,10000,0,0.00,100.00
1090529,710777,聚積元大9A購02,10000,10000,0,0.00,100.00
1090529,710778,璟德元大9A購02,8000,8000,0,0.00,100.00
1090529,710779,頎邦元大9A購03,7000,7000,0,0.00,100.00
1090529,710780,群聯群益9A購03,5000,5000,0,0.00,100.00
1090529,710781,大學光凱基9A購05,5000,5000,0,0.00,100.00
1090529,710782,精測凱基9A購07,5000,5000,0,0.00,100.00
1090529,710783,優群凱基9A購05,5000,5000,0,0.00,100.00
1090529,710784,寶雅凱基9A購02,5000,5000,0,0.00,100.00
1090529,710785,鈊象凱基9B購02,5000,5000,0,0.00,100.00
1090529,710786,神盾中信9C購01,5000,5000,0,0.00,100.00
1090529,710787,世界國票9A購01,5000,5000,0,0.00,100.00
1090529,710788,良維國票9A購02,5000,5000,0,0.00,100.00
1090529,710789,信驊國票9A購04,5000,5000,0,0.00,100.00
1090529,710790,原相國票9C購01,5000,5000,0,0.00,100.00
1090529,710791,泰博國票9A購04,5000,5000,0,0.00,100.00
1090529,710792,聖暉國票9A購02,5000,5000,0,0.00,100.00
1090529,710793,璟德國票9A購01,5000,5000,0,0.00,100.00
1090529,710794,雙美國票9A購02,5000,5000,0,0.00,100.00
1090529,710795,原相元大9B購05,5000,5000,0,0.00,100.00
1090529,710796,優群元大9A購04,10000,10000,0,0.00,100.00
1090529,710797,雙鴻元大9B購02,5000,5000,0,0.00,100.00
1090529,710798,頎邦元大9A購04,8000,8000,0,0.00,100.00
1090529,710799,網龍群益9A購02,5000,5000,0,0.00,100.00
1090529,710800,磐亞群益9A購01,5000,5000,0,0.00,100.00
1090529,710801,鈺太群益9A購02,5000,5000,0,0.00,100.00
1090529,710802,金居凱基9A購02,5000,5000,0,0.00,100.00
1090529,710803,信驊凱基9A購04,5000,5000,0,0.00,100.00
1090529,710804,鈊象凱基9A購04,5000,5000,0,0.00,100.00
1090529,710805,精測統一9B購02,10000,10000,0,0.00,100.00
1090529,710806,久元永豐9A購01,5000,5000,0,0.00,100.00
1090529,710807,亞泰永豐9A購01,5000,5000,0,0.00,100.00
1090529,710808,宜特永豐9A購02,5000,5000,0,0.00,100.00
1090529,710809,信驊永豐9A購01,5000,5000,0,0.00,100.00
1090529,710810,威剛永豐9A購03,5000,5000,0,0.00,100.00
1090529,710811,原相永豐9B購01,5000,5000,0,0.00,100.00
1090529,710812,聖暉永豐9A購01,5000,5000,0,0.00,100.00
1090529,710813,網家永豐9A購03,5000,5000,0,0.00,100.00
1090529,710814,網龍永豐9A購04,5000,5000,0,0.00,100.00
1090529,710815,雙美永豐9A購02,5000,5000,0,0.00,100.00
1090529,710816,雙鴻永豐9A購03,5000,5000,0,0.00,100.00
1090529,710817,群聯國票9A購03,5000,5000,0,0.00,100.00
1090529,710818,雙鴻富邦9B購02,10000,10000,0,0.00,100.00
1090529,710819,原相元大9B購06,8000,8000,0,0.00,100.00
1090529,710820,泰博元大9A購04,5000,5000,0,0.00,100.00
1090529,710821,櫃200元大9A購02,20000,20000,0,0.00,100.00
1090529,710822,凡甲群益9A購02,5000,5000,0,0.00,100.00
1090529,710823,大江群益9A購02,5000,5000,0,0.00,100.00
1090529,710824,新鉅科群益9A購03,5000,5000,0,0.00,100.00
1090529,710825,群聯群益9A購04,5000,5000,0,0.00,100.00
1090529,710826,聚積群益9A購01,5000,5000,0,0.00,100.00
1090529,710827,優群群益9A購02,5000,5000,0,0.00,100.00
1090529,710828,鈊象群益9A購06,5000,5000,0,0.00,100.00
1090529,710829,宜鼎國票9A購01,5000,5000,0,0.00,100.00
1090529,710830,網龍國票9A購01,5000,5000,0,0.00,100.00
1090529,710831,宜鼎中信9B購01,5000,5000,0,0.00,100.00
1090529,710832,信驊中信9A購01,5000,5000,0,0.00,100.00
1090529,710833,群聯中信9C購02,5000,5000,0,0.00,100.00
1090529,710834,中美晶凱基9A購06,5000,5000,0,0.00,100.00
1090529,710835,宏捷科凱基9A購06,5000,5000,0,0.00,100.00
1090529,710836,是方凱基9A購01,5000,5000,0,0.00,100.00
1090529,710837,碩禾凱基9A購02,5000,5000,0,0.00,100.00
1090529,710838,精測凱基9B購01,5000,5000,0,0.00,100.00
1090529,710839,網家凱基9A購02,5000,5000,0,0.00,100.00
1090529,710840,環球晶凱基9A購05,5000,5000,0,0.00,100.00
1090529,710841,穩懋凱基9A購07,5000,5000,0,0.00,100.00
1090529,710842,鈊象凱基9B購03,5000,5000,0,0.00,100.00
1090529,710843,原相麥證9A購01,10000,10000,0,0.00,100.00
1090529,710844,直得永豐9A購01,5000,5000,0,0.00,100.00
1090529,710845,是方永豐9A購02,5000,5000,0,0.00,100.00
1090529,710846,群聯元大9B購02,5000,5000,0,0.00,100.00
1090529,710847,精測元大9B購01,5000,5000,0,0.00,100.00
1090529,710848,網家元大9B購01,5000,5000,0,0.00,100.00
1090529,710849,鈊象元大9B購06,6000,6000,0,0.00,100.00
1090529,710850,鈊象元大9C購02,5000,5000,0,0.00,100.00
1090529,710851,力旺永豐9B購01,5000,5000,0,0.00,100.00
1090529,710852,宇峻永豐9B購02,5000,5000,0,0.00,100.00
1090529,710853,建榮永豐9B購03,5000,5000,0,0.00,100.00
1090529,710854,神盾永豐9C購01,5000,5000,0,0.00,100.00
1090529,710855,神準永豐9B購01,5000,5000,0,0.00,100.00
1090529,710856,廣明永豐9B購01,5000,5000,0,0.00,100.00
1090529,710857,優群永豐9B購01,5000,5000,0,0.00,100.00
1090529,710858,聯亞永豐9B購01,5000,5000,0,0.00,100.00
1090529,710859,威剛國票9B購01,5000,5000,0,0.00,100.00
1090529,710860,原相國票9C購02,5000,5000,0,0.00,100.00
1090529,710861,網家國票9B購01,5000,5000,0,0.00,100.00
1090529,710862,雙鴻國票9B購01,5000,5000,0,0.00,100.00
1090529,710863,神盾麥證9C購01,5000,5000,0,0.00,100.00
1090529,710864,群聯麥證9B購02,10000,10000,0,0.00,100.00
1090529,710865,大江凱基9C購01,5000,5000,0,0.00,100.00
1090529,710866,信昌電凱基9B購01,5000,5000,0,0.00,100.00
1090529,710867,原相凱基9B購03,5000,5000,0,0.00,100.00
1090529,710868,群聯凱基9B購05,5000,5000,0,0.00,100.00
1090529,710869,璟德凱基9B購01,5000,5000,0,0.00,100.00
1090529,710870,大學光群益9B購01,5000,5000,0,0.00,100.00
1090529,710871,中美晶群益9B購02,5000,5000,0,0.00,100.00
1090529,710872,是方群益9B購01,5000,5000,0,0.00,100.00
1090529,710873,原相群益9B購02,5000,5000,0,0.00,100.00
1090529,710874,神盾群益9C購01,5000,5000,0,0.00,100.00
1090529,710875,環球晶群益9B購01,5000,5000,0,0.00,100.00
1090529,710876,環球晶群益9B購02,5000,5000,0,0.00,100.00
1090529,710877,聯亞群益9B購01,5000,5000,0,0.00,100.00
1090529,710878,晟德群益9B購01,5000,5000,0,0.00,100.00
1090529,710879,神盾國泰01購01,5000,5000,0,0.00,100.00
1090529,710880,信昌電群益9B購01,5000,5000,0,0.00,100.00
1090529,710881,原相群益9B購03,5000,5000,0,0.00,100.00
1090529,710882,泰博群益9B購02,5000,5000,0,0.00,100.00
1090529,710883,群聯群益9B購01,5000,5000,0,0.00,100.00
1090529,710884,精測群益9B購01,5000,5000,0,0.00,100.00
1090529,710885,譜瑞群益9B購01,5000,5000,0,0.00,100.00
1090529,710886,六角凱基9B購01,5000,5000,0,0.00,100.00
1090529,710887,建榮凱基9B購02,5000,5000,0,0.00,100.00
1090529,710888,網家凱基9B購01,5000,5000,0,0.00,100.00
1090529,710889,廣明凱基9B購01,5000,5000,0,0.00,100.00
1090529,710890,聯亞統一9C購01,15000,15000,0,0.00,100.00
1090529,710891,穩懋統一9C購03,10000,10000,0,0.00,100.00
1090529,710892,大江國票9B購01,5000,5000,0,0.00,100.00
1090529,710893,宇峻國票9B購02,5000,5000,0,0.00,100.00
1090529,710894,是方國票9B購01,5000,5000,0,0.00,100.00
1090529,710895,群聯國票9B購01,5000,5000,0,0.00,100.00
1090529,710896,聯亞國票9B購01,5000,5000,0,0.00,100.00
1090529,710897,雙美國票9B購02,5000,5000,0,0.00,100.00
1090529,710898,鈊象國票9B購03,5000,5000,0,0.00,100.00
1090529,710899,凡甲元大9B購02,5000,5000,0,0.00,100.00
1090529,710900,威剛元大9C購01,5000,5000,0,0.00,100.00
1090529,710901,是方元大9B購01,6000,6000,0,0.00,100.00
1090529,710902,群聯元大9B購03,5000,5000,0,0.00,100.00
1090529,710903,雍智元大9C購01,5000,5000,0,0.00,100.00
1090529,710904,璟德元大9B購01,5000,5000,0,0.00,100.00
1090529,710905,璟德元大9B購02,8000,8000,0,0.00,100.00
1090529,710906,聯亞元大9B購01,6000,6000,0,0.00,100.00
1090529,710907,聯亞元大9B購02,8000,8000,0,0.00,100.00
1090529,710908,力旺中信9B購01,5000,5000,0,0.00,100.00
1090529,710909,宜鼎永豐9B購01,5000,5000,0,0.00,100.00
1090529,710910,金可永豐9B購01,5000,5000,0,0.00,100.00
1090529,710911,建榮永豐9B購04,5000,5000,0,0.00,100.00
1090529,710912,穩懋永豐9B購01,5000,5000,0,0.00,100.00
1090529,710913,雙鴻國泰01購01,5000,5000,0,0.00,100.00
1090529,710914,原相元大01購01,5000,5000,0,0.00,100.00
1090529,710915,精測元大9B購02,5000,5000,0,0.00,100.00
1090529,710916,鈊象元大9C購03,5000,5000,0,0.00,100.00
1090529,710917,碩禾台新9C購01,5000,5000,0,0.00,100.00
1090529,710918,威剛國票9B購02,5000,5000,0,0.00,100.00
1090529,710919,網家國票9B購02,5000,5000,0,0.00,100.00
1090529,710920,網龍國票9B購01,5000,5000,0,0.00,100.00
1090529,710921,雙鴻國票9B購02,5000,5000,0,0.00,100.00
1090529,710922,聯亞中信01購01,5000,5000,0,0.00,100.00
1090529,710923,六角永豐9B購01,5000,5000,0,0.00,100.00
1090529,710924,邦特永豐9B購01,5000,5000,0,0.00,100.00
1090529,710925,金居永豐9B購01,5000,5000,0,0.00,100.00
1090529,710926,新普永豐9B購01,5000,5000,0,0.00,100.00
1090529,710927,環球晶永豐9B購01,5000,5000,0,0.00,100.00
1090529,710928,鈺太永豐9B購01,5000,5000,0,0.00,100.00
1090529,710929,神盾凱基9B購03,5000,5000,0,0.00,100.00
1090529,710930,群聯統一01購01,5000,5000,0,0.00,100.00
1090529,710931,廣明統一9B購01,5000,5000,0,0.00,100.00
1090529,710932,群聯富邦9B購02,10000,10000,0,0.00,100.00
1090529,710933,泰博群益9B購03,5000,5000,0,0.00,100.00
1090529,710934,神盾群益9B購03,5000,5000,0,0.00,100.00
1090529,710935,聯亞群益9B購02,5000,5000,0,0.00,100.00
1090529,710936,鈊象群益9B購01,5000,5000,0,0.00,100.00
1090529,710937,精測台新9B購01,5000,5000,0,0.00,100.00
1090529,710938,環球晶國泰9C購01,5000,5000,0,0.00,100.00
1090529,710939,合晶群益9B購01,5000,5000,0,0.00,100.00
1090529,710940,原相群益9B購04,5000,5000,0,0.00,100.00
1090529,710941,博智群益9B購01,5000,5000,0,0.00,100.00
1090529,710942,網家群益9B購01,5000,5000,0,0.00,100.00
1090529,710943,六角元大9B購01,10000,10000,0,0.00,100.00
1090529,710944,宏捷科元大9B購04,6000,6000,0,0.00,100.00
1090529,710945,博智元大9B購02,8000,8000,0,0.00,100.00
1090529,710946,群聯元大9B購04,6000,6000,0,0.00,100.00
1090529,710947,網龍元大9B購01,8000,8000,0,0.00,100.00
1090529,710948,穩懋元大9B購01,5000,5000,0,0.00,100.00
1090529,710949,金居中信9C購02,5000,5000,0,0.00,100.00
1090529,710950,譜瑞中信03購01,5000,5000,0,0.00,100.00
1090529,710951,譜瑞中信05購01,5000,5000,0,0.00,100.00
1090529,710952,台燿永豐9B購01,5000,5000,0,0.00,100.00
1090529,710953,欣銓永豐9B購01,5000,5000,0,0.00,100.00
1090529,710954,博智永豐9B購01,5000,5000,0,0.00,100.00
1090529,710955,譜瑞永豐9B購01,5000,5000,0,0.00,100.00
1090529,710956,大江凱基9B購02,5000,5000,0,0.00,100.00
1090529,710957,泰博凱基9B購02,5000,5000,0,0.00,100.00
1090529,710958,博智凱基9B購02,5000,5000,0,0.00,100.00
1090529,710959,神盾統一9C購01,5000,5000,0,0.00,100.00
1090529,710960,群聯統一9B購02,5000,5000,0,0.00,100.00
1090529,710961,環球晶統一01購01,5000,5000,0,0.00,100.00
1090529,710962,環球晶統一9B購01,15000,15000,0,0.00,100.00
1090529,710963,環球晶統一9B購02,6500,6500,0,0.00,100.00
1090529,710964,環球晶統一9C購02,6000,6000,0,0.00,100.00
1090529,710965,頎邦統一9C購01,5000,5000,0,0.00,100.00
1090529,710966,弘塑國票9B購01,5000,5000,0,0.00,100.00
1090529,710967,宜鼎國票9B購01,5000,5000,0,0.00,100.00
1090529,710968,環球晶國票9C購01,5000,5000,0,0.00,100.00
1090529,710969,雙鴻國票9B購03,5000,5000,0,0.00,100.00
1090529,710970,元太元大9B購01,6000,6000,0,0.00,100.00
1090529,710971,弘塑元大9C購01,5000,5000,0,0.00,100.00
1090529,710972,金可元大9B購01,5000,5000,0,0.00,100.00
1090529,710973,金居元大9B購01,5000,5000,0,0.00,100.00
1090529,710974,南光元大9B購01,8000,8000,0,0.00,100.00
1090529,710975,威剛元大9B購04,5000,5000,0,0.00,100.00
1090529,710976,原相元大01購02,5000,5000,0,0.00,100.00
1090529,710977,泰博元大01購01,5000,5000,0,0.00,100.00
1090529,710978,群聯元大9B購05,5000,5000,0,0.00,100.00
1090529,710979,精測元大9B購03,6000,6000,0,0.00,100.00
1090529,710980,網家元大9B購02,8000,8000,0,0.00,100.00
1090529,710981,璟德元大9B購03,5000,5000,0,0.00,100.00
1090529,710982,聯亞元大9B購03,5000,5000,0,0.00,100.00
1090529,710983,雙鴻元大9C購04,5000,5000,0,0.00,100.00
1090529,710984,鈊象元大9C購04,5000,5000,0,0.00,100.00
1090529,710985,鈺太元大9C購01,5000,5000,0,0.00,100.00
1090529,710986,頎邦元大9B購01,5000,5000,0,0.00,100.00
1090529,710987,頎邦元大9B購02,6000,6000,0,0.00,100.00
1090529,710988,群聯中信01購01,5000,5000,0,0.00,100.00
1090529,710989,環球晶中信9C購02,5000,5000,0,0.00,100.00
1090529,710990,頎邦中信01購01,5000,5000,0,0.00,100.00
1090529,710991,大江永豐9B購01,5000,5000,0,0.00,100.00
1090529,710992,旺矽永豐9B購01,5000,5000,0,0.00,100.00
1090529,710993,雍智永豐9B購01,5000,5000,0,0.00,100.00
1090529,710994,環球晶麥證9B購01,15000,15000,0,0.00,100.00
1090529,710995,群聯統一01購02,15000,15000,0,0.00,100.00
1090529,710996,網家統一01購01,5000,5000,0,0.00,100.00
1090529,710997,穩懋統一9B購05,15000,15000,0,0.00,100.00
1090529,710998,大江國泰01購01,5000,5000,0,0.00,100.00
1090529,710999,聯亞國泰01購01,5000,5000,0,0.00,100.00
1090529,711000,雙美國泰01購01,6000,6000,0,0.00,100.00
1090529,711001,環球晶富邦01購01,20000,20000,0,0.00,100.00
1090529,711002,宏捷科群益9B購01,5000,5000,0,0.00,100.00
1090529,711003,環球晶群益9B購04,5000,5000,0,0.00,100.00
1090529,711004,大江元大9B購01,5000,5000,0,0.00,100.00
1090529,711005,欣銓元大9B購01,8000,8000,0,0.00,100.00
1090529,711006,金居元大9B購02,6000,6000,0,0.00,100.00
1090529,711007,建榮元大9B購02,8000,8000,0,0.00,100.00
1090529,711008,雙美元大9C購02,5000,5000,0,0.00,100.00
1090529,711009,鈺太元大9B購02,5000,5000,0,0.00,100.00
1090529,711010,大江國票9B購02,5000,5000,0,0.00,100.00
1090529,711011,神盾國票9C購02,5000,5000,0,0.00,100.00
1090529,711012,群聯國票9B購02,5000,5000,0,0.00,100.00
1090529,711013,環球晶國票9B購01,5000,5000,0,0.00,100.00
1090529,711014,久元永豐9B購01,5000,5000,0,0.00,100.00
1090529,711015,大學光永豐9B購01,5000,5000,0,0.00,100.00
1090529,711016,直得永豐9B購01,5000,5000,0,0.00,100.00
1090529,711017,南光永豐9B購01,5000,5000,0,0.00,100.00
1090529,711018,泰博永豐9B購01,5000,5000,0,0.00,100.00
1090529,711019,磐亞永豐9B購01,5000,5000,0,0.00,100.00
1090529,711020,雙美永豐9B購01,5000,5000,0,0.00,100.00
1090529,711021,力旺群益9B購01,5000,5000,0,0.00,100.00
1090529,711022,大江群益9B購01,5000,5000,0,0.00,100.00
1090529,711023,宇峻群益9B購02,5000,5000,0,0.00,100.00
1090529,711024,建榮群益9C購01,5000,5000,0,0.00,100.00
1090529,711025,原相群益9B購05,5000,5000,0,0.00,100.00
1090529,711026,群聯群益9B購02,5000,5000,0,0.00,100.00
1090529,711027,精測群益9B購02,5000,5000,0,0.00,100.00
1090529,711028,網家群益9B購02,5000,5000,0,0.00,100.00
1090529,711029,網龍群益9B購01,5000,5000,0,0.00,100.00
1090529,711030,環球晶群益9B購05,5000,5000,0,0.00,100.00
1090529,711031,頎邦群益9C購01,5000,5000,0,0.00,100.00
1090529,711032,博智群益9B購02,5000,5000,0,0.00,100.00
1090529,711033,大江凱基9C購02,5000,5000,0,0.00,100.00
1090529,711034,元太凱基9B購01,5000,5000,0,0.00,100.00
1090529,711035,欣銓凱基9B購01,5000,5000,0,0.00,100.00
1090529,711036,金居凱基9B購01,5000,5000,0,0.00,100.00
1090529,711037,威剛凱基9B購03,5000,5000,0,0.00,100.00
1090529,711038,新鉅科凱基9B購01,5000,5000,0,0.00,100.00
1090529,711039,中美晶統一9B購03,15000,15000,0,0.00,100.00
1090529,711040,穩懋統一9B購06,13000,13000,0,0.00,100.00
1090529,711041,頎邦統一9B購01,12000,12000,0,0.00,100.00
1090529,711042,弘塑麥證9B購01,9000,9000,0,0.00,100.00
1090529,711043,鈊象麥證9B購01,10000,10000,0,0.00,100.00
1090529,711044,久元元大9B購01,8000,8000,0,0.00,100.00
1090529,711045,大江元大9C購01,5000,5000,0,0.00,100.00
1090529,711046,金居元大9B購03,8000,8000,0,0.00,100.00
1090529,711047,建榮元大9B購03,8000,8000,0,0.00,100.00
1090529,711048,網家元大9B購03,6000,6000,0,0.00,100.00
1090529,711049,聯亞元大9B購04,5000,5000,0,0.00,100.00
1090529,711050,鈊象國泰01購01,5000,5000,0,0.00,100.00
1090529,711051,弘塑群益9B購01,5000,5000,0,0.00,100.00
1090529,711052,精測群益9B購03,5000,5000,0,0.00,100.00
1090529,711053,磐亞群益9B購01,5000,5000,0,0.00,100.00
1090529,711054,優群群益9B購01,5000,5000,0,0.00,100.00
1090529,711055,鈺太群益9B購01,5000,5000,0,0.00,100.00
1090529,711056,碩禾中信03購01,5000,5000,0,0.00,100.00
1090529,711057,良維永豐9B購01,5000,5000,0,0.00,100.00
1090529,711058,宜特永豐9B購01,5000,5000,0,0.00,100.00
1090529,711059,建榮永豐9B購05,5000,5000,0,0.00,100.00
1090529,711060,聚積永豐9B購01,5000,5000,0,0.00,100.00
1090529,711061,環宇永豐9B購01,5000,5000,0,0.00,100.00
1090529,711062,宏捷科凱基9C購03,5000,5000,0,0.00,100.00
1090529,711063,頎邦凱基9C購01,5000,5000,0,0.00,100.00
1090529,711064,凡甲統一01購01,5000,5000,0,0.00,100.00
1090529,711065,穩懋統一9B購08,15000,15000,0,0.00,100.00
1090529,711066,大學光國票9C購01,5000,5000,0,0.00,100.00
1090529,711067,宇峻國票9B購03,5000,5000,0,0.00,100.00
1090529,711068,群聯國泰01購01,5000,5000,0,0.00,100.00
1090529,711069,台燿永豐9B購02,5000,5000,0,0.00,100.00
1090529,711070,穩懋永豐9B購02,5000,5000,0,0.00,100.00
1090529,711071,凡甲元大9C購01,5000,5000,0,0.00,100.00
1090529,711072,大江元大9C購02,5000,5000,0,0.00,100.00
1090529,711073,台燿元大9B購01,8000,8000,0,0.00,100.00
1090529,711074,台燿元大9C購01,5000,5000,0,0.00,100.00
1090529,711075,宇峻元大01購01,5000,5000,0,0.00,100.00
1090529,711076,宏捷科元大9C購02,5000,5000,0,0.00,100.00
1090529,711077,宜鼎元大9B購01,8000,8000,0,0.00,100.00
1090529,711078,泰博元大9C購02,5000,5000,0,0.00,100.00
1090529,711079,群聯元大9B購06,8000,8000,0,0.00,100.00
1090529,711080,群聯元大9B購07,6000,6000,0,0.00,100.00
1090529,711081,雍智元大9C購02,5000,5000,0,0.00,100.00
1090529,711082,環球晶元大9C購01,8000,8000,0,0.00,100.00
1090529,711083,精測富邦9C購01,10000,10000,0,0.00,100.00
1090529,711084,穩懋富邦01購01,15000,15000,0,0.00,100.00
1090529,711085,台燿凱基9B購01,5000,5000,0,0.00,100.00
1090529,711086,威剛凱基01購01,5000,5000,0,0.00,100.00
1090529,711087,神盾凱基9B購04,5000,5000,0,0.00,100.00
1090529,711088,勝麗凱基9B購01,5000,5000,0,0.00,100.00
1090529,711089,環球晶凱基9B購04,5000,5000,0,0.00,100.00
1090529,711090,網家麥證9B購01,10000,10000,0,0.00,100.00
1090529,711091,弘塑統一01購01,5000,5000,0,0.00,100.00
1090529,711092,金居統一9B購01,17000,17000,0,0.00,100.00
1090529,711093,頎邦統一9C購02,8500,8500,0,0.00,100.00
1090529,711094,信驊元大9B購01,5000,5000,0,0.00,100.00
1090529,711095,精測元大9C購01,5000,5000,0,0.00,100.00
1090529,711096,網家元大9B購04,5000,5000,0,0.00,100.00
1090529,711097,中美晶國泰01購01,5000,5000,0,0.00,100.00
1090529,711098,大學光群益9B購02,5000,5000,0,0.00,100.00
1090529,711099,台燿群益9B購02,5000,5000,0,0.00,100.00
1090529,711100,新普群益9C購01,5000,5000,0,0.00,100.00
1090529,711101,環宇群益9B購01,5000,5000,0,0.00,100.00
1090529,711102,中美晶國票9B購01,5000,5000,0,0.00,100.00
1090529,711103,元太國票9B購01,5000,5000,0,0.00,100.00
1090529,711104,磐亞國票9B購01,5000,5000,0,0.00,100.00
1090529,711105,博智凱基9B購03,5000,5000,0,0.00,100.00
1090529,711106,群聯凱基9B購06,5000,5000,0,0.00,100.00
1090529,711107,璟德凱基9B購02,5000,5000,0,0.00,100.00
1090529,711108,鈺太凱基9C購01,5000,5000,0,0.00,100.00
1090529,711109,頎邦凱基9B購01,5000,5000,0,0.00,100.00
1090529,711110,台燿統一01購01,5000,5000,0,0.00,100.00
1090529,711111,群聯統一9C購01,10000,10000,0,0.00,100.00
1090529,711112,穩懋統一01購01,10000,10000,0,0.00,100.00
1090529,711113,穩懋統一9C購04,15000,15000,0,0.00,100.00
1090529,711114,寶雅中信9B購01,5000,5000,0,0.00,100.00
1090529,711115,中美晶永豐9B購01,5000,5000,0,0.00,100.00
1090529,711116,台半永豐9B購01,5000,5000,0,0.00,100.00
1090529,711117,旺矽永豐9B購02,5000,5000,0,0.00,100.00
1090529,711118,金居永豐9B購02,5000,5000,0,0.00,100.00
1090529,711119,群聯永豐9B購02,5000,5000,0,0.00,100.00
1090529,711120,精華永豐9B購01,5000,5000,0,0.00,100.00
1090529,711121,璟德永豐9B購01,5000,5000,0,0.00,100.00
1090529,711122,雙美永豐9B購02,5000,5000,0,0.00,100.00
1090529,711123,大江元大9C購03,6000,6000,0,0.00,100.00
1090529,711124,原相元大9C購01,5000,5000,0,0.00,100.00
1090529,711125,神盾元大9C購02,5000,5000,0,0.00,100.00
1090529,711126,聯亞元大9B購05,5000,5000,0,0.00,100.00
1090529,711127,頎邦元大9B購03,8000,8000,0,0.00,100.00
1090529,711128,金居國泰01購01,5000,5000,0,0.00,100.00
1090529,711129,威剛國泰01購01,5000,5000,0,0.00,100.00
1090529,711130,譜瑞國泰01購01,5000,5000,0,0.00,100.00
1090529,711131,胡連永豐9B購01,5000,5000,0,0.00,100.00
1090529,711132,僑威永豐9B購01,5000,5000,0,0.00,100.00
1090529,711133,寶雅永豐9B購01,5000,5000,0,0.00,100.00
1090529,711134,中美晶群益9B購03,5000,5000,0,0.00,100.00
1090529,711135,元太群益9B購01,5000,5000,0,0.00,100.00
1090529,711136,威剛群益9C購01,5000,5000,0,0.00,100.00
1090529,711137,胡連群益9B購01,5000,5000,0,0.00,100.00
1090529,711138,雙美群益9C購01,5000,5000,0,0.00,100.00
1090529,711139,中美晶凱基9B購02,5000,5000,0,0.00,100.00
1090529,711140,旺矽凱基9B購01,5000,5000,0,0.00,100.00
1090529,711141,胡連凱基9B購01,5000,5000,0,0.00,100.00
1090529,711142,鈊象凱基9C購01,5000,5000,0,0.00,100.00
1090529,711143,大學光統一02購01,5000,5000,0,0.00,100.00
1090529,711144,寶雅統一01購01,5000,5000,0,0.00,100.00
1090529,711145,環球晶國票9B購02,5000,5000,0,0.00,100.00
1090529,711146,雍智群益9B購01,5000,5000,0,0.00,100.00
1090529,711147,優群群益9B購02,5000,5000,0,0.00,100.00
1090529,711148,凡甲國泰01購01,6200,6200,0,0.00,100.00
1090529,711149,網龍國泰01購01,5000,5000,0,0.00,100.00
1090529,711150,環球晶國泰9B購01,5000,5000,0,0.00,100.00
1090529,711151,泰博中信01購01,5000,5000,0,0.00,100.00
1090529,711152,大田永豐9B購01,5000,5000,0,0.00,100.00
1090529,711153,大學光永豐9B購02,5000,5000,0,0.00,100.00
1090529,711154,合晶永豐9B購01,5000,5000,0,0.00,100.00
1090529,711155,泰博永豐9B購02,5000,5000,0,0.00,100.00
1090529,711156,網龍永豐9B購01,5000,5000,0,0.00,100.00
1090529,711157,大學光元大9C購02,5000,5000,0,0.00,100.00
1090529,711158,中美晶元大9B購02,6000,6000,0,0.00,100.00
1090529,711159,中美晶元大9B購03,6000,6000,0,0.00,100.00
1090529,711160,元太元大9B購02,5000,5000,0,0.00,100.00
1090529,711161,泰博元大9C購03,5000,5000,0,0.00,100.00
1090529,711162,雍智元大9C購03,5000,5000,0,0.00,100.00
1090529,711163,網龍元大9B購02,5000,5000,0,0.00,100.00
1090529,711164,環球晶元大9C購02,10000,10000,0,0.00,100.00
1090529,711165,聯亞元大9C購01,5000,5000,0,0.00,100.00
1090529,711166,雙美元大9C購03,5000,5000,0,0.00,100.00
1090529,711167,神盾麥證9C購02,5000,5000,0,0.00,100.00
1090529,711168,原相凱基9B購04,5000,5000,0,0.00,100.00
1090529,711169,精測凱基01購01,5000,5000,0,0.00,100.00
1090529,711170,網家凱基9B購02,5000,5000,0,0.00,100.00
1090529,711171,雙鴻凱基9B購02,5000,5000,0,0.00,100.00
1090529,711172,穩懋凱基9B購03,5000,5000,0,0.00,100.00
1090529,711173,群聯統一9B購03,20000,20000,0,0.00,100.00
1090529,711174,寶雅統一01購02,15000,15000,0,0.00,100.00
1090529,711175,寶雅統一9B購01,20000,20000,0,0.00,100.00
1090529,711176,久元國票9B購01,5000,5000,0,0.00,100.00
1090529,711177,大江國票9B購03,5000,5000,0,0.00,100.00
1090529,711178,宇峻國票9B購04,5000,5000,0,0.00,100.00
1090529,711179,胡連國票9B購01,5000,5000,0,0.00,100.00
1090529,711180,環球晶國票9C購02,5000,5000,0,0.00,100.00
1090529,711181,譜瑞台新9B購01,5000,5000,0,0.00,100.00
1090529,711182,原相國泰9C購01,5000,5000,0,0.00,100.00
1090529,711183,泰博國泰01購01,5000,5000,0,0.00,100.00
1090529,711184,穩懋國泰9C購01,5000,5000,0,0.00,100.00
1090529,711185,大學光元大9C購03,5000,5000,0,0.00,100.00
1090529,711186,中美晶元大9B購04,8000,8000,0,0.00,100.00
1090529,711187,環球晶元大9B購01,6000,6000,0,0.00,100.00
1090529,711188,穩懋元大9C購01,8000,8000,0,0.00,100.00
1090529,711189,久元凱基9B購01,5000,5000,0,0.00,100.00
1090529,711190,大江凱基9B購03,5000,5000,0,0.00,100.00
1090529,711191,信驊凱基9B購01,5000,5000,0,0.00,100.00
1090529,711192,群聯凱基9B購07,5000,5000,0,0.00,100.00
1090529,711193,碩禾凱基9B購03,5000,5000,0,0.00,100.00
1090529,711194,環球晶凱基9B購05,5000,5000,0,0.00,100.00
1090529,711195,元太統一9B購01,15000,15000,0,0.00,100.00
1090529,711196,世界統一9C購01,15000,15000,0,0.00,100.00
1090529,711197,精測統一9C購01,10000,10000,0,0.00,100.00
1090529,711198,聯亞統一9B購01,10000,10000,0,0.00,100.00
1090529,711199,元太富邦9C購01,15000,15000,0,0.00,100.00
1090529,711200,合晶富邦9C購01,10000,10000,0,0.00,100.00
1090529,711201,泰博群益9B購04,5000,5000,0,0.00,100.00
1090529,711202,群聯群益9B購05,5000,5000,0,0.00,100.00
1090529,711203,雍智群益9B購02,5000,5000,0,0.00,100.00
1090529,711204,雙鴻群益9C購01,5000,5000,0,0.00,100.00
1090529,711205,合晶兆豐9B購01,5000,5000,0,0.00,100.00
1090529,711206,金可兆豐9B購01,5000,5000,0,0.00,100.00
1090529,711207,群聯兆豐9C購01,5000,5000,0,0.00,100.00
1090529,711208,群聯兆豐9C購02,5000,5000,0,0.00,100.00
1090529,711209,譜瑞兆豐9B購01,5000,5000,0,0.00,100.00
1090529,711210,世界國票9B購01,5000,5000,0,0.00,100.00
1090529,711211,是方國票9B購02,5000,5000,0,0.00,100.00
1090529,711212,聯亞國票9B購03,5000,5000,0,0.00,100.00
1090529,711213,鈊象國票9B購04,5000,5000,0,0.00,100.00
1090529,711214,是方中信9B購01,5000,5000,0,0.00,100.00
1090529,711215,力旺永豐9B購02,5000,5000,0,0.00,100.00
1090529,711216,世界永豐9B購01,5000,5000,0,0.00,100.00
1090529,711217,建榮永豐9C購01,5000,5000,0,0.00,100.00
1090529,711218,泰博永豐9C購01,5000,5000,0,0.00,100.00
1090529,711219,雍智永豐9B購02,5000,5000,0,0.00,100.00
1090529,711220,信驊永豐9B購01,5000,5000,0,0.00,100.00
1090529,711221,建榮永豐9B購06,5000,5000,0,0.00,100.00
1090529,711222,泰博永豐9B購03,5000,5000,0,0.00,100.00
1090529,711223,譜瑞永豐9B購02,5000,5000,0,0.00,100.00
1090529,711224,凡甲元大9C購02,5000,5000,0,0.00,100.00
1090529,711225,金居元大9B購04,5000,5000,0,0.00,100.00
1090529,711226,新普元大9B購01,8000,8000,0,0.00,100.00
1090529,711227,新鉅科元大9B購02,5000,5000,0,0.00,100.00
1090529,711228,精測元大9C購02,5000,5000,0,0.00,100.00
1090529,711229,廣明元大9B購01,8000,8000,0,0.00,100.00
1090529,711230,譜瑞元大9B購01,6000,6000,0,0.00,100.00
1090529,711231,群聯統一9B購04,5000,5000,0,0.00,100.00
1090529,711232,中美晶凱基9C購01,5000,5000,0,0.00,100.00
1090529,711233,世界凱基9B購01,5000,5000,0,0.00,100.00
1090529,711234,宏捷科凱基9C購04,5000,5000,0,0.00,100.00
1090529,711235,網家凱基9C購02,5000,5000,0,0.00,100.00
1090529,711236,元太國票9B購02,5000,5000,0,0.00,100.00
1090529,711237,信驊國票9B購01,5000,5000,0,0.00,100.00
1090529,711238,泰博國票9B購02,5000,5000,0,0.00,100.00
1090529,711239,雍智國票9B購01,5000,5000,0,0.00,100.00
1090529,711240,廣明國票9B購01,5000,5000,0,0.00,100.00
1090529,711241,譜瑞國票9B購01,5000,5000,0,0.00,100.00
1090529,711242,世界群益9C購01,5000,5000,0,0.00,100.00
1090529,711243,旺矽群益9B購01,5000,5000,0,0.00,100.00
1090529,711244,金可群益9B購01,5000,5000,0,0.00,100.00
1090529,711245,大江兆豐9C購01,5000,5000,0,0.00,100.00
1090529,711246,台燿兆豐9B購01,5000,5000,0,0.00,100.00
1090529,711247,旺矽兆豐9B購01,5000,5000,0,0.00,100.00
1090529,711248,金居兆豐9B購01,5000,5000,0,0.00,100.00
1090529,711249,頎邦兆豐9B購01,5000,5000,0,0.00,100.00
1090529,711250,元太元富9B購01,5000,5000,0,0.00,100.00
1090529,711251,金居元富9B購01,5000,5000,0,0.00,100.00
1090529,711252,信驊元富9B購01,5000,5000,0,0.00,100.00
1090529,711253,神盾元富9B購03,5000,5000,0,0.00,100.00
1090529,711254,群聯麥證9C購01,13000,13000,0,0.00,100.00
1090529,711255,大學光國泰9C購01,5000,5000,0,0.00,100.00
1090529,711256,元太國泰01購01,5000,5000,0,0.00,100.00
1090529,711257,勝麗群益9B購01,5000,5000,0,0.00,100.00
1090529,711258,環球晶富邦01購02,10000,10000,0,0.00,100.00
1090529,711259,大學光國票9C購03,5000,5000,0,0.00,100.00
1090529,711260,旺矽國票9B購01,5000,5000,0,0.00,100.00
1090529,711261,金居國票9B購01,5000,5000,0,0.00,100.00
1090529,711262,新普國票9B購01,5000,5000,0,0.00,100.00
1090529,711263,雙美國票9B購03,5000,5000,0,0.00,100.00
1090529,711264,大學光永豐9B購03,5000,5000,0,0.00,100.00
1090529,711265,神盾永豐9B購02,5000,5000,0,0.00,100.00
1090529,711266,鈊象永豐9B購02,5000,5000,0,0.00,100.00
1090529,711267,金居凱基9B購02,5000,5000,0,0.00,100.00
1090529,711268,新普凱基9B購01,5000,5000,0,0.00,100.00
1090529,711269,聯亞凱基9B購01,5000,5000,0,0.00,100.00
1090529,711270,台燿統一01購02,5000,5000,0,0.00,100.00
1090529,711271,瓦城統一01購01,5000,5000,0,0.00,100.00
1090529,711272,譜瑞統一9C購01,15000,15000,0,0.00,100.00
1090529,711273,鈊象統一9B購02,10000,10000,0,0.00,100.00
1090529,711274,力旺元大9B購01,8000,8000,0,0.00,100.00
1090529,711275,元太元大9B購03,8000,8000,0,0.00,100.00
1090529,711276,宇峻元大9C購02,5000,5000,0,0.00,100.00
1090529,711277,旺矽元大9B購02,5000,5000,0,0.00,100.00
1090529,711278,旺矽元大9B購03,8000,8000,0,0.00,100.00
1090529,711279,信驊元大9B購02,8000,8000,0,0.00,100.00
1090529,711280,是方元大9C購01,8000,8000,0,0.00,100.00
1090529,711281,閎康元大9B購01,8000,8000,0,0.00,100.00
1090529,711282,群聯元大9B購09,5000,5000,0,0.00,100.00
1090529,711283,聯亞元大9B購06,5000,5000,0,0.00,100.00
1090529,711284,信驊兆豐9B購01,5000,5000,0,0.00,100.00
1090529,711285,穩懋兆豐9C購01,5000,5000,0,0.00,100.00
1090529,711286,弘塑元富9B購02,5000,5000,0,0.00,100.00
1090529,711287,環球晶元富9B購03,5000,5000,0,0.00,100.00
1090529,711288,環球晶元富9B購04,5000,5000,0,0.00,100.00
1090529,711289,新普麥證9B購01,10000,10000,0,0.00,100.00
1090529,711290,鈊象麥證9C購01,10000,10000,0,0.00,100.00
1090529,711291,網家國泰01購01,5000,5000,0,0.00,100.00
1090529,711292,M31永豐9B購01,5000,5000,0,0.00,100.00
1090529,711293,力旺永豐9B購03,5000,5000,0,0.00,100.00
1090529,711294,原相永豐9B購02,5000,5000,0,0.00,100.00
1090529,711295,精測永豐9B購01,5000,5000,0,0.00,100.00
1090529,711296,力旺元大9B購02,10000,10000,0,0.00,100.00
1090529,711297,中美晶元大9B購05,8000,8000,0,0.00,100.00
1090529,711298,世界元大9B購01,5000,5000,0,0.00,100.00
1090529,711299,世界元大9B購02,6000,6000,0,0.00,100.00
1090529,711300,信昌電元大9B購01,8000,8000,0,0.00,100.00
1090529,711301,博智元大9C購01,5000,5000,0,0.00,100.00
1090529,711302,群聯元大9B購10,10000,10000,0,0.00,100.00
1090529,711303,譜瑞元大9B購02,6000,6000,0,0.00,100.00
1090529,711304,信驊群益9B購01,5000,5000,0,0.00,100.00
1090529,711305,精測群益9B購04,5000,5000,0,0.00,100.00
1090529,711306,環球晶群益9C購01,5000,5000,0,0.00,100.00
1090529,711307,聚積國票9B購01,5000,5000,0,0.00,100.00
1090529,711308,M31統一9C購01,10000,10000,0,0.00,100.00
1090529,711309,久元統一01購01,5000,5000,0,0.00,100.00
1090529,711310,原相統一01購01,10000,10000,0,0.00,100.00
1090529,711311,環球晶統一9C購03,9000,9000,0,0.00,100.00
1090529,711312,雙鴻統一9C購02,5000,5000,0,0.00,100.00
1090529,711313,穩懋凱基9C購02,5000,5000,0,0.00,100.00
1090529,711314,凡甲麥證9B購01,5000,5000,0,0.00,100.00
1090529,711315,精測麥證9C購01,10000,10000,0,0.00,100.00
1090529,711316,中美晶元富9B購03,5000,5000,0,0.00,100.00
1090529,711317,博智元富9B購01,5000,5000,0,0.00,100.00
1090529,711318,網家元富9B購01,5000,5000,0,0.00,100.00
1090529,711319,璟德兆豐9B購01,5000,5000,0,0.00,100.00
1090529,711320,聯亞兆豐9B購01,5000,5000,0,0.00,100.00
1090529,711321,原相元大9B購07,8000,0,8000,0.00,100.00
1090529,711322,環球晶元大9B購02,5000,0,5000,0.00,100.00
1090529,711323,環球晶元大9B購03,5000,0,5000,0.00,100.00
1090529,711324,凡甲富邦9C購01,6000,0,6000,0.00,100.00
1090529,711325,久元群益9B購01,5000,0,5000,0.00,100.00
1090529,711326,金居群益9C購01,5000,0,5000,0.00,100.00
1090529,711327,群聯群益9B購06,5000,0,5000,0.00,100.00
1090529,711328,譜瑞群益9B購02,5000,0,5000,0.00,100.00
1090529,711329,譜瑞統一01購01,5000,0,5000,0.00,100.00
1090529,711330,元太凱基9C購01,5000,0,5000,0.00,100.00
1090529,711331,台燿凱基9B購03,5000,0,5000,0.00,100.00
1090529,711332,聯亞凱基9C購01,5000,0,5000,0.00,100.00
1090529,711333,久元中信9B購01,5000,0,5000,0.00,100.00
1090529,711334,久元永豐9B購02,5000,0,5000,0.00,100.00
1090529,711335,大田永豐9B購02,5000,0,5000,0.00,100.00
1090529,711336,茂達永豐9B購01,5000,0,5000,0.00,100.00
1090529,711337,順達永豐9B購01,5000,0,5000,0.00,100.00
1090529,711338,網家永豐9B購01,5000,0,5000,0.00,100.00
1090529,711339,晟德永豐9B購01,5000,0,5000,0.00,100.00
1090529,711340,M31國票9C購01,5000,0,5000,0.00,100.00
1090529,711341,世界元富9B購01,5000,0,5000,0.00,100.00
1090529,711342,晶焱元富9B購01,5000,0,5000,0.00,100.00
1090529,711343,雍智國泰01購01,5000,0,5000,0.00,100.00
1090529,711344,力旺元大9B購03,10000,0,10000,0.00,100.00
1090529,711345,久元元大9B購02,8000,0,8000,0.00,100.00
1090529,711346,大江元大9B購02,10000,0,10000,0.00,100.00
1090529,711347,元太元大9B購04,8000,0,8000,0.00,100.00
1090529,711348,合晶元大9B購01,10000,0,10000,0.00,100.00
1090529,711349,宇峻元大9B購02,5000,0,5000,0.00,100.00
1090529,711350,宜鼎元大9B購02,10000,0,10000,0.00,100.00
1090529,711351,金居元大9C購01,10000,0,10000,0.00,100.00
1090529,711352,新普元大9B購02,5000,0,5000,0.00,100.00
1090529,711353,新普元大9B購03,8000,0,8000,0.00,100.00
1090529,711354,網家元大9B購05,10000,0,10000,0.00,100.00
1090529,711355,環球晶元大9C購03,10000,0,10000,0.00,100.00
1090529,711356,大江群益9C購01,5000,0,5000,0.00,100.00
1090529,711357,世界群益9C購02,5000,0,5000,0.00,100.00
1090529,711358,宜鼎群益9B購01,5000,0,5000,0.00,100.00
1090529,711359,雙美群益9C購02,5000,0,5000,0.00,100.00
1090529,711360,晟德群益9B購02,5000,0,5000,0.00,100.00
1090529,711361,鈊象群益9B購04,5000,0,5000,0.00,100.00
1090529,711362,原相第一9B購01,5000,0,5000,0.00,100.00
1090529,711363,皇田永豐9B購01,5000,0,5000,0.00,100.00
1090529,711364,力旺麥證9B購01,10000,0,10000,0.00,100.00
1090529,711365,合晶凱基9B購01,5000,0,5000,0.00,100.00
1090529,711366,是方凱基9B購01,5000,0,5000,0.00,100.00
1090529,711367,原相凱基9B購05,5000,0,5000,0.00,100.00
1090529,711368,優群凱基9B購02,5000,0,5000,0.00,100.00
1090529,711369,聯亞凱基01購01,5000,0,5000,0.00,100.00
1090529,711370,鈊象凱基9B購04,5000,0,5000,0.00,100.00
1090529,711371,久元統一01購02,10000,0,10000,0.00,100.00
1090529,711372,久元統一01購03,20000,0,20000,0.00,100.00
1090529,711373,雙鴻統一9B購01,10000,0,10000,0.00,100.00
1090529,711374,穩懋統一9C購05,15000,0,15000,0.00,100.00
1090529,711375,寶雅統一01購03,20000,0,20000,0.00,100.00
1090529,711376,群聯富邦9C購01,10000,0,10000,0.00,100.00
1090529,711377,精測富邦9C購02,7000,0,7000,0.00,100.00
1090529,711378,鈊象富邦9C購01,10000,0,10000,0.00,100.00
1090529,711379,凡甲國票9C購01,5000,0,5000,0.00,100.00
1090529,711380,弘塑國票9C購01,5000,0,5000,0.00,100.00
1090529,711381,原相國票9B購03,5000,0,5000,0.00,100.00
1090529,711382,雍智國票9B購02,5000,0,5000,0.00,100.00
1090529,711383,鈊象國票9B購05,5000,0,5000,0.00,100.00
1090529,711384,久元元富9B購01,5000,0,5000,0.00,100.00
1090529,711385,旺矽元富9B購01,5000,0,5000,0.00,100.00
1090529,711386,神盾元富9C購01,5000,0,5000,0.00,100.00
1090529,711387,新普元富9B購01,5000,0,5000,0.00,100.00
1090529,711388,大江兆豐9B購01,5000,0,5000,0.00,100.00
1090529,711389,元太兆豐9B購01,5000,0,5000,0.00,100.00
1090529,711390,台燿兆豐9B購02,5000,0,5000,0.00,100.00
1090529,711391,力旺國票9B購01,5000,0,5000,0.00,100.00
1090529,711392,元太國票9B購03,5000,0,5000,0.00,100.00
1090529,711393,金居國票9C購01,5000,0,5000,0.00,100.00
1090529,711394,頎邦國票9C購01,5000,0,5000,0.00,100.00
1090529,711395,六角凱基9B購02,5000,0,5000,0.00,100.00
1090529,711396,聯亞凱基9B購02,5000,0,5000,0.00,100.00
1090529,711397,晟德凱基9B購01,5000,0,5000,0.00,100.00
1090529,711398,元太富邦01購01,10000,0,10000,0.00,100.00
1090529,711399,元太統一01購01,10000,0,10000,0.00,100.00
1090529,711400,元太統一9C購01,15000,0,15000,0.00,100.00
1090529,711401,穩懋統一9B購11,15000,0,15000,0.00,100.00
1090529,711402,寶雅統一01購04,15000,0,15000,0.00,100.00
1090529,711403,台燿元大9B購02,8000,0,8000,0.00,100.00
1090529,711404,旺矽元大9B購04,10000,0,10000,0.00,100.00
1090529,711405,信驊元大9C購01,8000,0,8000,0.00,100.00
1090529,711406,胡連元大9B購01,8000,0,8000,0.00,100.00
1090529,711407,網家元大9B購06,10000,0,10000,0.00,100.00
1090529,711408,環球晶元大9B購04,5000,0,5000,0.00,100.00
1090529,711409,晟德元大9B購01,10000,0,10000,0.00,100.00
1090529,711410,邦特永豐9B購02,5000,0,5000,0.00,100.00
1090529,711411,是方永豐9B購01,5000,0,5000,0.00,100.00
1090529,711412,聯亞永豐9B購02,5000,0,5000,0.00,100.00
1090529,711413,大江群益9B購03,5000,0,5000,0.00,100.00
1090529,711414,元太群益9B購02,5000,0,5000,0.00,100.00
1090529,711415,威剛群益9C購02,5000,0,5000,0.00,100.00
1090529,711416,是方群益9B購02,5000,0,5000,0.00,100.00
1090529,711417,璟德群益9B購01,5000,0,5000,0.00,100.00
1090529,711418,元太元富9B購02,5000,0,5000,0.00,100.00
1090529,711419,聯亞元富9B購01,5000,0,5000,0.00,100.00
1090529,711420,網家兆豐9C購01,5000,0,5000,0.00,100.00
1090529,711421,優群兆豐9B購01,5000,0,5000,0.00,100.00
1090529,711422,信驊國泰01購01,5000,0,5000,0.00,100.00
1090529,711423,是方國泰9C購01,5000,0,5000,0.00,100.00
1090529,711424,大江群益9B購04,5000,0,5000,0.00,100.00
1090529,711425,宜特群益9B購01,5000,0,5000,0.00,100.00
1090529,711426,環球晶群益9C購02,5000,0,5000,0.00,100.00
1090529,711427,雙美群益9C購03,5000,0,5000,0.00,100.00
1090529,711428,雙鴻群益9C購02,5000,0,5000,0.00,100.00
1090529,711429,力旺元大9B購04,8000,0,8000,0.00,100.00
1090529,711430,元太元大9B購05,5000,0,5000,0.00,100.00
1090529,711431,宏捷科元大9C購03,5000,0,5000,0.00,100.00
1090529,711432,精測元大9C購03,5000,0,5000,0.00,100.00
1090529,711433,優群元大9C購01,6000,0,6000,0.00,100.00
1090529,711434,環球晶元大9C購04,10000,0,10000,0.00,100.00
1090529,711435,譜瑞元大9B購03,8000,0,8000,0.00,100.00
1090529,711436,鈊象元大9C購05,8000,0,8000,0.00,100.00
1090529,711437,穩懋台新9B購01,5000,0,5000,0.00,100.00
1090529,711438,久元凱基9C購01,5000,0,5000,0.00,100.00
1090529,711439,大江凱基9B購04,5000,0,5000,0.00,100.00
1090529,711440,元太凱基9B購02,5000,0,5000,0.00,100.00
1090529,711441,弘塑凱基9C購01,5000,0,5000,0.00,100.00
1090529,711442,原相凱基01購01,5000,0,5000,0.00,100.00
1090529,711443,順達凱基9B購01,5000,0,5000,0.00,100.00
1090529,711444,鈊象凱基03購01,5000,0,5000,0.00,100.00
1090529,711445,久元國票9B購02,5000,0,5000,0.00,100.00
1090529,711446,邦特國票9C購01,5000,0,5000,0.00,100.00
1090529,711447,旺矽國票9C購01,5000,0,5000,0.00,100.00
1090529,711448,中美晶統一9B購04,13000,0,13000,0.00,100.00
1090529,711449,合晶統一9C購01,10000,0,10000,0.00,100.00
1090529,711450,網家中信9B購01,5000,0,5000,0.00,100.00
1090529,711451,雙鴻中信01購01,10000,0,10000,0.00,100.00
1090529,711452,宜特永豐9B購02,5000,0,5000,0.00,100.00
1090529,711453,信驊永豐9B購03,5000,0,5000,0.00,100.00
1090529,711454,閎康永豐9B購01,5000,0,5000,0.00,100.00
1090529,711455,網家永豐9B購02,5000,0,5000,0.00,100.00
1090529,711456,穩懋永豐9B購03,5000,0,5000,0.00,100.00
1090529,711457,鈊象永豐9B購03,5000,0,5000,0.00,100.00
1090529,711458,元太國泰01購02,5000,0,5000,0.00,100.00
1090529,711459,譜瑞國泰01購02,5000,0,5000,0.00,100.00
1090529,711460,頎邦國泰9C購01,5000,0,5000,0.00,100.00
1090529,711461,合晶群益9B購02,5000,0,5000,0.00,100.00
1090529,711462,是方群益9B購03,5000,0,5000,0.00,100.00
1090529,711463,閎康群益9B購01,5000,0,5000,0.00,100.00
1090529,711464,新普群益9C購03,5000,0,5000,0.00,100.00
1090529,711465,譜瑞群益9B購03,5000,0,5000,0.00,100.00
1090529,711466,宇峻永豐9B購03,5000,0,5000,0.00,100.00
1090529,711467,精測永豐9B購02,5000,0,5000,0.00,100.00
1090529,711468,穩懋永豐9B購04,5000,0,5000,0.00,100.00
1090529,711469,大江元大9C購04,5000,0,5000,0.00,100.00
1090529,711470,信驊元大9C購02,8000,0,8000,0.00,100.00
1090529,711471,建榮元大9B購04,10000,0,10000,0.00,100.00
1090529,711472,是方元大9B購02,10000,0,10000,0.00,100.00
1090529,711473,新普元大9B購04,8000,0,8000,0.00,100.00
1090529,711474,雍智元大9C購04,5000,0,5000,0.00,100.00
1090529,711475,雙美元大9C購04,5000,0,5000,0.00,100.00
1090529,711476,譜瑞元大9B購04,8000,0,8000,0.00,100.00
1090529,711477,大學光富邦9B購01,10000,0,10000,0.00,100.00
1090529,711478,宏捷科麥證9B購01,5000,0,5000,0.00,100.00
1090529,711479,大學光統一03購01,5000,0,5000,0.00,100.00
1090529,711480,元太統一9B購02,15000,0,15000,0.00,100.00
1090529,711481,智擎統一9C購01,10000,0,10000,0.00,100.00
1090529,711482,網家統一01購02,5000,0,5000,0.00,100.00
1090529,711483,穩懋統一01購02,5000,0,5000,0.00,100.00
1090529,711484,晟德統一9B購01,19000,0,19000,0.00,100.00
1090529,711485,元太凱基9B購03,5000,0,5000,0.00,100.00
1090529,711486,世界凱基01購01,5000,0,5000,0.00,100.00
1090529,711487,旺矽凱基01購01,5000,0,5000,0.00,100.00
1090529,711488,信驊凱基9B購02,5000,0,5000,0.00,100.00
1090529,711489,信驊凱基9B購03,5000,0,5000,0.00,100.00
1090529,711490,聯亞凱基01購02,5000,0,5000,0.00,100.00
1090529,711491,大學光兆豐9C購01,5000,0,5000,0.00,100.00
1090529,711492,信驊兆豐9B購02,5000,0,5000,0.00,100.00
1090529,711493,譜瑞兆豐9B購02,5000,0,5000,0.00,100.00
1090529,711494,旺矽元富9C購01,5000,0,5000,0.00,100.00
1090529,711495,信驊元富03購01,5000,0,5000,0.00,100.00
1090529,711496,原相元富03購01,5000,0,5000,0.00,100.00
1090529,711497,網家元富03購01,5000,0,5000,0.00,100.00
1090529,711498,雙美元富9B購01,5000,0,5000,0.00,100.00
1090529,72510P,原相群益96售02,5000,5000,0,0.00,100.00
1090529,72535P,雙鴻群益95售01,0,500,-500,-100.00,100.00
1090529,72548P,大江統一96售01,500,500,0,0.00,100.00
1090529,72568P,新普群益96售01,600,600,0,0.00,100.00
1090529,72572P,網家元富96售02,500,500,0,0.00,100.00
1090529,72594P,雙鴻國泰96售03,500,500,0,0.00,100.00
1090529,72595P,大江富邦96售01,1000,1000,0,0.00,100.00
1090529,72611P,雙鴻凱基96售02,500,500,0,0.00,100.00
1090529,72623P,穩懋富邦96售02,10000,10000,0,0.00,100.00
1090529,72624P,櫃200第一96售02,5000,5000,0,0.00,100.00
1090529,72638P,中美晶元富95售03,0,500,-500,-100.00,100.00
1090529,72655P,穩懋統一96售03,500,500,0,0.00,100.00
1090529,72658P,建榮國票95售03,500,500,0,0.00,100.00
1090529,72661P,穩懋中信96售01,2000,2000,0,0.00,100.00
1090529,72662P,穩懋中信98售01,6000,6000,0,0.00,100.00
1090529,72663P,神盾元富96售01,500,500,0,0.00,100.00
1090529,72672P,穩懋國票96售01,500,500,0,0.00,100.00
1090529,72673P,穩懋國泰96售01,500,500,0,0.00,100.00
1090529,72674P,環球晶富邦97售02,1248,1248,0,0.00,100.00
1090529,72684P,大江國票96售02,500,500,0,0.00,100.00
1090529,72686P,新普群益97售03,1500,1500,0,0.00,100.00
1090529,72689P,環宇國票96售01,500,500,0,0.00,100.00
1090529,72697P,穩懋亞東96售01,1300,1300,0,0.00,100.00
1090529,72703P,聯亞群益96售01,600,600,0,0.00,100.00
1090529,72704P,大江國票96售03,500,500,0,0.00,100.00
1090529,72706P,環球晶國泰96售02,1294,1294,0,0.00,100.00
1090529,72707P,中美晶國票96售02,1000,1000,0,0.00,100.00
1090529,72711P,櫃200永昌96售05,500,500,0,0.00,100.00
1090529,72713P,櫃200元大96售01,1000,1000,0,0.00,100.00
1090529,72714P,櫃200元大96售02,1000,1000,0,0.00,100.00
1090529,72716P,穩懋統一96售04,2400,2400,0,0.00,100.00
1090529,72719P,原相亞東96售02,700,700,0,0.00,100.00
1090529,72732P,櫃200T永昌96售05,634,634,0,0.00,100.00
1090529,72733P,櫃200凱基96售01,5000,5000,0,0.00,100.00
1090529,72734P,櫃200凱基96售02,5000,5000,0,0.00,100.00
1090529,72737P,櫃200富邦9A售03,1000,1000,0,0.00,100.00
1090529,72738P,櫃200富邦9A售04,1001,1001,0,0.00,100.00
1090529,72740P,中美晶元大95售05,0,1500,-1500,-100.00,100.00
1090529,72741P,良維元大95售03,0,1000,-1000,-100.00,100.00
1090529,72742P,雙鴻元大95售03,0,500,-500,-100.00,100.00
1090529,72743P,群聯永豐95售02,0,500,-500,-100.00,100.00
1090529,72744P,神盾元大95售07,0,500,-500,-100.00,100.00
1090529,72745P,威剛國票96售01,1000,1000,0,0.00,100.00
1090529,72746P,大江富邦97售02,2000,10000,-8000,-80.00,100.00
1090529,72747P,櫃200T永昌9C售05,500,500,0,0.00,100.00
1090529,72748P,穩懋康和95售01,0,13000,-13000,-100.00,100.00
1090529,72749P,金居元大95售04,0,600,-600,-100.00,100.00
1090529,72750P,精華元大95售04,0,1000,-1000,-100.00,100.00
1090529,72751P,元太中信95售02,0,5000,-5000,-100.00,100.00
1090529,72752P,環球晶凱基96售02,500,500,0,0.00,100.00
1090529,72753P,新普永豐95售02,0,500,-500,-100.00,100.00
1090529,72754P,大江群益95售02,0,500,-500,-100.00,100.00
1090529,72755P,精華凱基95售02,0,500,-500,-100.00,100.00
1090529,72756P,穩懋凱基95售02,0,500,-500,-100.00,100.00
1090529,72757P,精華統一95售01,0,5000,-5000,-100.00,100.00
1090529,72758P,環球晶凱基95售14,0,500,-500,-100.00,100.00
1090529,72759P,精華永豐95售03,0,500,-500,-100.00,100.00
1090529,72760P,精測元大95售01,0,1000,-1000,-100.00,100.00
1090529,72761P,中美晶富邦96售01,10000,10000,0,0.00,100.00
1090529,72762P,穩懋富邦97售02,10000,10000,0,0.00,100.00
1090529,72763P,精測中信96售01,1000,1000,0,0.00,100.00
1090529,72764P,中美晶凱基96售02,500,500,0,0.00,100.00
1090529,72765P,精測國泰97售01,800,800,0,0.00,100.00
1090529,72766P,中美晶富邦97售01,10000,10000,0,0.00,100.00
1090529,72767P,精測康和96售01,1000,1000,0,0.00,100.00
1090529,72768P,精測凱基96售02,500,500,0,0.00,100.00
1090529,72769P,雙鴻兆豐97售01,1000,1000,0,0.00,100.00
1090529,72770P,精測永豐96售03,500,500,0,0.00,100.00
1090529,72771P,鈊象元大96售01,1500,1500,0,0.00,100.00
1090529,72772P,同致國票97售01,500,500,0,0.00,100.00
1090529,72773P,鈊象國票96售01,6000,6000,0,0.00,100.00
1090529,72774P,精測群益96售02,550,550,0,0.00,100.00
1090529,72775P,精測統一96售02,1000,1000,0,0.00,100.00
1090529,72776P,精測凱基96售05,500,500,0,0.00,100.00
1090529,72777P,櫃200凱基96售04,5000,5000,0,0.00,100.00
1090529,72778P,櫃200凱基96售05,5000,5000,0,0.00,100.00
1090529,72779P,鈊象凱基96售02,1000,1000,0,0.00,100.00
1090529,72780P,鈊象台新96售01,500,500,0,0.00,100.00
1090529,72781P,鈊象永豐96售02,500,500,0,0.00,100.00
1090529,72782P,鈊象康和96售01,1000,1000,0,0.00,100.00
1090529,72783P,鈊象群益96售01,1200,1200,0,0.00,100.00
1090529,72784P,精測統一96售03,1000,1000,0,0.00,100.00
1090529,72785P,鈊象元富96售02,1000,1000,0,0.00,100.00
1090529,72786P,聯亞國票97售02,1000,1000,0,0.00,100.00
1090529,72787P,精測永豐96售05,500,500,0,0.00,100.00
1090529,72788P,群聯群益96售03,1000,1000,0,0.00,100.00
1090529,72789P,精測群益96售03,600,600,0,0.00,100.00
1090529,72790P,精華群益96售01,5000,5000,0,0.00,100.00
1090529,72791P,精測凱基96售06,500,500,0,0.00,100.00
1090529,72792P,穩懋國票96售04,500,500,0,0.00,100.00
1090529,72793P,穩懋兆豐96售03,5000,5000,0,0.00,100.00
1090529,72794P,穩懋兆豐97售01,5000,5000,0,0.00,100.00
1090529,72795P,鈊象元大96售02,500,500,0,0.00,100.00
1090529,72796P,穩懋統一97售02,5000,5000,0,0.00,100.00
1090529,72797P,鈊象統一97售01,5000,5000,0,0.00,100.00
1090529,72798P,穩懋凱基96售08,500,500,0,0.00,100.00
1090529,72799P,世界永豐96售01,500,500,0,0.00,100.00
1090529,72800P,鈊象元富96售03,1000,1000,0,0.00,100.00
1090529,72801P,中美晶元大96售01,600,600,0,0.00,100.00
1090529,72802P,世界元大96售04,6000,6000,0,0.00,100.00
1090529,72803P,中美晶中信98售01,5000,5000,0,0.00,100.00
1090529,72804P,世界中信96售02,3000,3000,0,0.00,100.00
1090529,72805P,鈊象元富96售04,1000,1000,0,0.00,100.00
1090529,72806P,世界康和96售02,5000,5000,0,0.00,100.00
1090529,72807P,網龍群益98售02,600,600,0,0.00,100.00
1090529,72808P,力旺康和96售01,5000,5000,0,0.00,100.00
1090529,72809P,聯亞元富96售01,1000,1000,0,0.00,100.00
1090529,72810P,雙鴻元富96售02,1000,1000,0,0.00,100.00
1090529,72811P,鈊象元富96售05,1000,1000,0,0.00,100.00
1090529,72812P,世界統一96售01,5000,5000,0,0.00,100.00
1090529,72813P,宣德統一97售01,5000,5000,0,0.00,100.00
1090529,72814P,世界群益98售03,2000,2000,0,0.00,100.00
1090529,72815P,宣德元大96售05,800,800,0,0.00,100.00
1090529,72816P,信昌電國票97售02,500,500,0,0.00,100.00
1090529,72817P,網龍國票97售03,500,500,0,0.00,100.00
1090529,72818P,櫃200第一96售05,5000,5000,0,0.00,100.00
1090529,72819P,櫃200第一96售06,5000,5000,0,0.00,100.00
1090529,72820P,中美晶兆豐97售01,5000,5000,0,0.00,100.00
1090529,72821P,櫃200永昌97售02,500,500,0,0.00,100.00
1090529,72822P,櫃200永昌97售03,500,500,0,0.00,100.00
1090529,72823P,櫃200永昌99售04,500,500,0,0.00,100.00
1090529,72824P,櫃200永昌99售05,500,500,0,0.00,100.00
1090529,72825P,緯軟永豐96售01,500,500,0,0.00,100.00
1090529,72826P,穩懋統一96售11,5000,5000,0,0.00,100.00
1090529,72827P,穩懋統一96售12,5000,5000,0,0.00,100.00
1090529,72828P,新普凱基96售01,500,500,0,0.00,100.00
1090529,72829P,神盾群益98售02,5000,5000,0,0.00,100.00
1090529,72830P,櫃200永昌9B售02,500,500,0,0.00,100.00
1090529,72831P,櫃200永昌9B售03,500,500,0,0.00,100.00
1090529,72832P,櫃200永昌9C售04,575,575,0,0.00,100.00
1090529,72833P,櫃200永昌9C售05,501,501,0,0.00,100.00
1090529,72834P,威剛元富99售01,2000,2000,0,0.00,100.00
1090529,72835P,環球晶中信9A售01,10000,10000,0,0.00,100.00
1090529,72836P,聯亞永豐96售02,500,500,0,0.00,100.00
1090529,72837P,雙鴻永豐96售01,500,500,0,0.00,100.00
1090529,72838P,M31元大96售03,500,500,0,0.00,100.00
1090529,72839P,世界元富96售03,2000,2000,0,0.00,100.00
1090529,72840P,聖暉統一97售01,5000,5000,0,0.00,100.00
1090529,72841P,環球晶凱基96售09,500,500,0,0.00,100.00
1090529,72842P,宣德永豐96售02,500,500,0,0.00,100.00
1090529,72843P,精測永豐96售11,500,500,0,0.00,100.00
1090529,72844P,精測國泰97售03,500,500,0,0.00,100.00
1090529,72845P,精測元大96售05,500,500,0,0.00,100.00
1090529,72846P,穩懋元大96售08,10000,10000,0,0.00,100.00
1090529,72847P,鈊象元大96售05,500,500,0,0.00,100.00
1090529,72848P,信驊康和96售01,2200,2200,0,0.00,100.00
1090529,72849P,櫃200永昌98售03,500,500,0,0.00,100.00
1090529,72850P,櫃200永昌98售04,500,500,0,0.00,100.00
1090529,72851P,佳邦永豐96售02,500,500,0,0.00,100.00
1090529,72852P,信昌電永豐96售01,500,500,0,0.00,100.00
1090529,72853P,穩懋元大96售09,10000,10000,0,0.00,100.00
1090529,72854P,勝麗國票97售02,500,500,0,0.00,100.00
1090529,72855P,精測元大96售06,500,500,0,0.00,100.00
1090529,72856P,閎康統一96售01,5000,5000,0,0.00,100.00
1090529,72857P,聯亞凱基96售02,500,500,0,0.00,100.00
1090529,72858P,直得永豐96售02,500,500,0,0.00,100.00
1090529,72859P,原相永豐96售02,600,1100,-500,-45.45,100.00
1090529,72860P,環球晶永豐96售01,500,1000,-500,-50.00,100.00
1090529,72861P,精測群益96售07,800,800,0,0.00,100.00
1090529,72862P,力旺國票96售01,500,500,0,0.00,100.00
1090529,72863P,群聯元大96售05,1000,1000,0,0.00,100.00
1090529,72864P,良維永豐96售04,500,500,0,0.00,100.00
1090529,72865P,聯亞國票97售03,1000,6000,-5000,-83.33,100.00
1090529,72866P,原相台新96售01,5000,5000,0,0.00,100.00
1090529,72867P,頎邦元富96售03,1000,1000,0,0.00,100.00
1090529,72868P,頎邦永豐96售01,500,500,0,0.00,100.00
1090529,72869P,頎邦元大96售01,1000,1000,0,0.00,100.00
1090529,72870P,頎邦群益97售03,3000,3000,0,0.00,100.00
1090529,72871P,鈊象國票97售02,5178,5178,0,0.00,100.00
1090529,72872P,大江永豐96售04,500,500,0,0.00,100.00
1090529,72873P,穩懋凱基96售14,500,500,0,0.00,100.00
1090529,72874P,台燿元富96售01,2500,2500,0,0.00,100.00
1090529,72875P,碩禾台新97售02,5000,5000,0,0.00,100.00
1090529,72876P,頎邦康和96售02,5000,5000,0,0.00,100.00
1090529,72877P,環球晶統一96售03,5500,5500,0,0.00,100.00
1090529,72878P,穩懋統一96售13,5000,5000,0,0.00,100.00
1090529,72879P,環球晶中信96售03,2500,2500,0,0.00,100.00
1090529,72880P,台燿凱基96售04,500,500,0,0.00,100.00
1090529,72881P,穩懋凱基96售15,500,500,0,0.00,100.00
1090529,72882P,威剛國票96售02,500,500,0,0.00,100.00
1090529,72883P,雍智國泰97售01,1000,1000,0,0.00,100.00
1090529,72884P,中美晶元富97售01,2500,2500,0,0.00,100.00
1090529,72885P,晶焱永豐97售02,500,500,0,0.00,100.00
1090529,72886P,旺矽康和97售01,1000,5000,-4000,-80.00,100.00
1090529,72887P,威剛康和97售01,1000,1000,0,0.00,100.00
1090529,72888P,中美晶中信99售01,5000,5000,0,0.00,100.00
1090529,72889P,合晶永豐97售02,733,733,0,0.00,100.00
1090529,72890P,金居永豐97售01,658,658,0,0.00,100.00
1090529,72891P,優群永豐97售02,970,970,0,0.00,100.00
1090529,72892P,精測康和97售01,1000,1000,0,0.00,100.00
1090529,72893P,櫃200群益97售03,1700,1700,0,0.00,100.00
1090529,72894P,中美晶凱基97售03,500,500,0,0.00,100.00
1090529,72895P,穩懋日盛97售03,10000,10000,0,0.00,100.00
1090529,72896P,廣明永豐97售02,500,500,0,0.00,100.00
1090529,72897P,璟德永豐97售01,500,500,0,0.00,100.00
1090529,72898P,雙鴻國票98售01,500,500,0,0.00,100.00
1090529,72899P,中美晶群益97售02,1600,1600,0,0.00,100.00
1090529,72900P,聯亞群益97售01,700,700,0,0.00,100.00
1090529,72901P,穩懋統一97售04,5000,5000,0,0.00,100.00
1090529,72902P,精測元富97售01,1000,1000,0,0.00,100.00
1090529,72903P,中美晶國票97售03,500,500,0,0.00,100.00
1090529,72904P,大江群益97售03,700,700,0,0.00,100.00
1090529,72905P,穩懋國泰98售01,950,950,0,0.00,100.00
1090529,72906P,穩懋國泰99售01,700,700,0,0.00,100.00
1090529,72907P,穩懋兆豐98售01,5000,5000,0,0.00,100.00
1090529,72908P,原相永豐97售01,700,900,-200,-22.22,100.00
1090529,72909P,穩懋永豐97售01,1000,1000,0,0.00,100.00
1090529,72910P,穩懋統一99售02,5000,5000,0,0.00,100.00
1090529,72911P,穩懋元大97售05,2000,2000,0,0.00,100.00
1090529,72912P,原相中信99售02,5000,5000,0,0.00,100.00
1090529,72913P,旺矽統一97售02,1000,5000,-4000,-80.00,100.00
1090529,72914P,穩懋元大97售06,4500,4500,0,0.00,100.00
1090529,72915P,中美晶凱基97售06,500,500,0,0.00,100.00
1090529,72916P,穩懋凱基97售04,500,500,0,0.00,100.00
1090529,72917P,網龍國票98售01,500,500,0,0.00,100.00
1090529,72918P,環球晶元富97售02,500,500,0,0.00,100.00
1090529,72919P,聯亞元富97售02,1000,2000,-1000,-50.00,100.00
1090529,72920P,雙鴻元富97售02,5000,5000,0,0.00,100.00
1090529,72921P,雙鴻元大98售01,500,500,0,0.00,100.00
1090529,72922P,原相亞東99售01,600,600,0,0.00,100.00
1090529,72923P,台燿永豐97售01,1000,1000,0,0.00,100.00
1090529,72924P,精測凱基97售05,500,500,0,0.00,100.00
1090529,72925P,鈊象凱基97售02,500,500,0,0.00,100.00
1090529,72926P,精華元大97售02,5000,5000,0,0.00,100.00
1090529,72927P,大江元富97售02,5000,5000,0,0.00,100.00
1090529,72928P,宜鼎元富97售02,5000,5000,0,0.00,100.00
1090529,72929P,信驊元富97售02,2500,2500,0,0.00,100.00
1090529,72930P,威剛元富97售03,5000,5000,0,0.00,100.00
1090529,72931P,新普元富97售02,2000,2000,0,0.00,100.00
1090529,72932P,網家元富97售02,1000,1000,0,0.00,100.00
1090529,72933P,碩禾永豐97售01,500,500,0,0.00,100.00
1090529,72934P,晟德永豐97售01,500,500,0,0.00,100.00
1090529,72935P,鈊象永豐97售03,1500,1500,0,0.00,100.00
1090529,72936P,鈊象元富97售03,5000,5000,0,0.00,100.00
1090529,72937P,櫃200元大99售01,1000,1000,0,0.00,100.00
1090529,72938P,櫃200元大99售02,1000,1000,0,0.00,100.00
1090529,72939P,網龍元大97售02,500,500,0,0.00,100.00
1090529,72940P,環球晶群益97售04,1600,1600,0,0.00,100.00
1090529,72941P,環球晶統一97售03,5000,5000,0,0.00,100.00
1090529,72942P,群聯元富97售01,1000,3500,-2500,-71.42,100.00
1090529,72943P,雙鴻元富97售03,5000,5000,0,0.00,100.00
1090529,72944P,信昌電元富97售01,5000,5000,0,0.00,100.00
1090529,72945P,大江永豐97售04,500,500,0,0.00,100.00
1090529,72946P,穩懋富邦99售02,15000,15000,0,0.00,100.00
1090529,72947P,環球晶凱基97售08,500,500,0,0.00,100.00
1090529,72948P,大江元大97售06,500,500,0,0.00,100.00
1090529,72949P,環球晶永豐97售02,1000,1000,0,0.00,100.00
1090529,72950P,中美晶元富97售02,5000,5000,0,0.00,100.00
1090529,72951P,宣德元富97售02,5000,5000,0,0.00,100.00
1090529,72952P,群聯元富97售02,3500,3500,0,0.00,100.00
1090529,72953P,環球晶元富97售05,500,500,0,0.00,100.00
1090529,72954P,穩懋元富97售05,3500,3500,0,0.00,100.00
1090529,72955P,中美晶元大98售02,500,500,0,0.00,100.00
1090529,72956P,信驊元大98售01,3500,3500,0,0.00,100.00
1090529,72957P,精測元富98售01,3500,3500,0,0.00,100.00
1090529,72958P,威剛元大98售03,500,500,0,0.00,100.00
1090529,72959P,大江永豐98售02,500,500,0,0.00,100.00
1090529,72960P,中美晶永豐98售01,500,500,0,0.00,100.00
1090529,72961P,環球晶國泰99售01,700,700,0,0.00,100.00
1090529,72962P,鈊象元富98售01,15000,15000,0,0.00,100.00
1090529,72963P,環球晶凱基98售03,500,500,0,0.00,100.00
1090529,72964P,環球晶元大98售05,5000,5000,0,0.00,100.00
1090529,72965P,環球晶元大98售06,6000,6000,0,0.00,100.00
1090529,72966P,環球晶元大98售07,8000,8000,0,0.00,100.00
1090529,72967P,精測國泰9A售02,500,500,0,0.00,100.00
1090529,72968P,大江元富98售03,3500,3500,0,0.00,100.00
1090529,72969P,精測元大98售03,5000,5000,0,0.00,100.00
1090529,72970P,原相永豐98售01,500,500,0,0.00,100.00
1090529,72971P,穩懋凱基98售05,500,500,0,0.00,100.00
1090529,72972P,大江元富98售04,3500,3500,0,0.00,100.00
1090529,72973P,大江富邦9A售03,10000,10000,0,0.00,100.00
1090529,72974P,精測元大98售04,600,800,-200,-25.00,100.00
1090529,72975P,緯軟元大9A售01,5850,5850,0,0.00,100.00
1090529,72976P,環球晶元大98售08,5000,5000,0,0.00,100.00
1090529,72977P,晶焱永豐98售02,1000,1000,0,0.00,100.00
1090529,72978P,新鉅科元大98售02,800,800,0,0.00,100.00
1090529,72979P,聯亞元大98售02,5000,5000,0,0.00,100.00
1090529,72980P,穩懋元大98售03,5000,5000,0,0.00,100.00
1090529,72981P,聯亞凱基98售03,500,500,0,0.00,100.00
1090529,72982P,精測元大98售05,500,500,0,0.00,100.00
1090529,72983P,穩懋元大98售04,500,500,0,0.00,100.00
1090529,72984P,威剛永豐98售02,500,500,0,0.00,100.00
1090529,72985P,群聯元富98售03,5000,5000,0,0.00,100.00
1090529,72986P,環球晶元大98售11,6000,6000,0,0.00,100.00
1090529,72987P,環球晶元大98售12,5000,5000,0,0.00,100.00
1090529,72988P,聯亞元大98售03,5000,5000,0,0.00,100.00
1090529,72989P,信昌電永豐98售02,500,500,0,0.00,100.00
1090529,72990P,環球晶凱基98售06,500,500,0,0.00,100.00
1090529,72991P,穩懋凱基98售08,500,500,0,0.00,100.00
1090529,72992P,穩懋永豐98售02,500,500,0,0.00,100.00
1090529,72993P,穩懋元富98售01,3500,3500,0,0.00,100.00
1090529,72994P,穩懋元富98售02,3500,3500,0,0.00,100.00
1090529,72995P,雙鴻兆豐99售02,5000,5000,0,0.00,100.00
1090529,72996P,力旺元富98售02,3500,3500,0,0.00,100.00
1090529,72997P,精測台新98售02,5000,5000,0,0.00,100.00
1090529,72998P,穩懋台新98售01,5000,5000,0,0.00,100.00
1090529,72999P,環球晶群益98售03,500,500,0,0.00,100.00
1090529,73000P,穩懋富邦99售03,10000,10000,0,0.00,100.00
1090529,73001P,譜瑞元大98售05,5000,5000,0,0.00,100.00
1090529,73002P,精測元富98售03,3500,3500,0,0.00,100.00
1090529,73003P,神盾群益9A售04,2300,2300,0,0.00,100.00
1090529,73004P,譜瑞台新99售01,5000,5000,0,0.00,100.00
1090529,73005P,中美晶元大98售07,500,500,0,0.00,100.00
1090529,73006P,聯亞元大98售04,1500,1500,0,0.00,100.00
1090529,73007P,中美晶元富98售01,3000,3000,0,0.00,100.00
1090529,73008P,合晶元富98售02,3000,3000,0,0.00,100.00
1090529,73009P,原相元富98售02,3500,3500,0,0.00,100.00
1090529,73010P,勝麗元富98售01,3000,3000,0,0.00,100.00
1090529,73011P,原相台新98售01,5000,5000,0,0.00,100.00
1090529,73012P,威剛統一98售02,5000,5000,0,0.00,100.00
1090529,73013P,中美晶群益98售05,2300,2300,0,0.00,100.00
1090529,73014P,環球晶國泰9A售02,500,500,0,0.00,100.00
1090529,73015P,碩禾元大99售04,500,500,0,0.00,100.00
1090529,73016P,精測元大98售06,1000,1000,0,0.00,100.00
1090529,73017P,環球晶統一99售05,15000,15000,0,0.00,100.00
1090529,73018P,威剛國票99售02,3000,3800,-800,-21.05,100.00
1090529,73019P,穩懋國泰99售02,500,500,0,0.00,100.00
1090529,73020P,穩懋亞東98售02,1800,1800,0,0.00,100.00
1090529,73021P,原相元大99售02,600,600,0,0.00,100.00
1090529,73022P,台燿中信9A售02,5000,5000,0,0.00,100.00
1090529,73023P,新普中信9C售01,5000,5000,0,0.00,100.00
1090529,73024P,譜瑞中信9C售01,5000,5000,0,0.00,100.00
1090529,73025P,譜瑞凱基98售03,5500,5500,0,0.00,100.00
1090529,73026P,泰博永豐98售02,1000,1000,0,0.00,100.00
1090529,73027P,雙鴻元大9A售02,1500,1500,0,0.00,100.00
1090529,73028P,中美晶統一9B售01,15000,15000,0,0.00,100.00
1090529,73029P,中美晶凱基99售06,500,500,0,0.00,100.00
1090529,73030P,大江群益99售01,1450,1450,0,0.00,100.00
1090529,73031P,宏捷科康和99售02,5000,5000,0,0.00,100.00
1090529,73032P,雙鴻群益9B售01,3000,3000,0,0.00,100.00
1090529,73033P,宏捷科國票99售01,1000,1000,0,0.00,100.00
1090529,73034P,大江富邦9B售01,6000,6000,0,0.00,100.00
1090529,73035P,中美晶台新99售01,5000,5000,0,0.00,100.00
1090529,73036P,鈊象永豐99售02,1500,1500,0,0.00,100.00
1090529,73037P,海韻電元富99售02,5000,5000,0,0.00,100.00
1090529,73038P,中美晶台新99售02,5000,5000,0,0.00,100.00
1090529,73039P,原相台新99售01,5000,5000,0,0.00,100.00
1090529,73040P,穩懋凱基99售04,619,619,0,0.00,100.00
1090529,73041P,穩懋統一9B售02,15000,15000,0,0.00,100.00
1090529,73042P,原相元大99售04,1000,1000,0,0.00,100.00
1090529,73043P,穩懋元大99售04,5000,5000,0,0.00,100.00
1090529,73044P,原相國票9A售01,1500,1500,0,0.00,100.00
1090529,73045P,雙鴻國票9A售02,1000,1000,0,0.00,100.00
1090529,73046P,神盾群益9A售05,5000,5000,0,0.00,100.00
1090529,73047P,宏捷科元富9C售03,5000,5000,0,0.00,100.00
1090529,73048P,中美晶中信9B售01,5000,5000,0,0.00,100.00
1090529,73049P,宏捷科元大99售05,1000,1000,0,0.00,100.00
1090529,73050P,雍智元大99售02,1500,1500,0,0.00,100.00
1090529,73051P,台燿元富9C售02,5000,5000,0,0.00,100.00
1090529,73052P,原相統一99售03,5000,5000,0,0.00,100.00
1090529,73053P,原相統一9A售02,5000,5000,0,0.00,100.00
1090529,73054P,穩懋元大99售08,1500,1500,0,0.00,100.00
1090529,73055P,信驊永豐99售03,2000,2000,0,0.00,100.00
1090529,73056P,原相永豐99售02,1500,1500,0,0.00,100.00
1090529,73057P,環球晶兆豐99售02,5000,5000,0,0.00,100.00
1090529,73058P,原相統一9B售02,5000,5000,0,0.00,100.00
1090529,73059P,鈊象元大99售05,3500,3500,0,0.00,100.00
1090529,73060P,環球晶凱基99售06,2500,2700,-200,-7.40,100.00
1090529,73061P,群聯元大9A售01,1400,1400,0,0.00,100.00
1090529,73062P,群聯凱基99售02,5000,5000,0,0.00,100.00
1090529,73063P,環球晶凱基99售10,2500,2600,-100,-3.84,100.00
1090529,73064P,中美晶富邦9B售02,5000,5000,0,0.00,100.00
1090529,73065P,鈊象元富99售01,5000,5000,0,0.00,100.00
1090529,73066P,環球晶元大99售07,8000,8000,0,0.00,100.00
1090529,73067P,環球晶元大99售08,8000,8000,0,0.00,100.00
1090529,73068P,穩懋元大99售12,8000,8000,0,0.00,100.00
1090529,73069P,聯亞富邦9B售01,10000,10000,0,0.00,100.00
1090529,73070P,元太亞東99售02,2000,2000,0,0.00,100.00
1090529,73071P,雙鴻元富99售02,5000,5000,0,0.00,100.00
1090529,73072P,環球晶元大99售12,5000,5000,0,0.00,100.00
1090529,73073P,穩懋元大99售19,5000,5000,0,0.00,100.00
1090529,73074P,聯亞國票99售04,1000,1000,0,0.00,100.00
1090529,73075P,中美晶元大99售06,1000,1000,0,0.00,100.00
1090529,73076P,中美晶元大99售07,1000,1000,0,0.00,100.00
1090529,73077P,環球晶元大99售16,6000,6000,0,0.00,100.00
1090529,73078P,環球晶元大99售17,8000,8000,0,0.00,100.00
1090529,73079P,環球晶凱基99售14,2500,2800,-300,-10.71,100.00
1090529,73080P,穩懋凱基99售11,2500,3000,-500,-16.66,100.00
1090529,73081P,環球晶國泰9A售04,5000,5000,0,0.00,100.00
1090529,73082P,精測元富9A售01,5000,5000,0,0.00,100.00
1090529,73083P,環球晶凱基9A售03,2600,2600,0,0.00,100.00
1090529,73084P,穩懋凱基9A售03,2500,3300,-800,-24.24,100.00
1090529,73085P,群聯國票9A售02,1000,1000,0,0.00,100.00
1090529,73086P,鈊象國票9A售01,1000,1000,0,0.00,100.00
1090529,73087P,穩懋元大9A售03,1500,1500,0,0.00,100.00
1090529,73088P,穩懋元大9A售04,8000,8000,0,0.00,100.00
1090529,73089P,群聯凱基9A售03,5000,5000,0,0.00,100.00
1090529,73090P,環球晶國票9A售01,1000,1000,0,0.00,100.00
1090529,73091P,穩懋康和9A售01,10000,10000,0,0.00,100.00
1090529,73092P,新普元大9A售01,8000,8000,0,0.00,100.00
1090529,73093P,精測凱基9A售03,5000,5000,0,0.00,100.00
1090529,73094P,中美晶國票9A售03,1000,1000,0,0.00,100.00
1090529,73095P,穩懋元大9A售05,1500,1500,0,0.00,100.00
1090529,73096P,世界元大9A售02,10000,10000,0,0.00,100.00
1090529,73097P,群聯元大9A售04,8000,8000,0,0.00,100.00
1090529,73098P,信驊凱基9A售02,2500,2800,-300,-10.71,100.00
1090529,73099P,穩懋國泰9B售02,5000,5000,0,0.00,100.00
1090529,73100P,神盾元富9A售02,5000,5000,0,0.00,100.00
1090529,73101P,中美晶凱基9A售05,2600,2600,0,0.00,100.00
1090529,73102P,原相元大9A售06,5000,5000,0,0.00,100.00
1090529,73103P,穩懋富邦9C售01,15000,15000,0,0.00,100.00
1090529,73104P,原相元大9A售07,10000,10000,0,0.00,100.00
1090529,73105P,穩懋國票9A售03,500,500,0,0.00,100.00
1090529,73106P,原相永豐9A售03,5000,5000,0,0.00,100.00
1090529,73107P,原相國票9B售02,3000,3000,0,0.00,100.00
1090529,73108P,鈊象國票9A售03,700,1000,-300,-30.00,100.00
1090529,73109P,神盾永豐9A售04,5000,5000,0,0.00,100.00
1090529,73110P,環球晶統一9A售01,5000,5000,0,0.00,100.00
1090529,73111P,穩懋統一9A售03,5000,5000,0,0.00,100.00
1090529,73112P,信驊國票9A售03,1500,1500,0,0.00,100.00
1090529,73113P,穩懋國票9A售04,1000,1500,-500,-33.33,100.00
1090529,73114P,穩懋元大9A售06,6000,6000,0,0.00,100.00
1090529,73115P,鈊象元大9A售03,5000,5000,0,0.00,100.00
1090529,73116P,原相凱基9A售04,5000,5000,0,0.00,100.00
1090529,73117P,鈊象永豐9A售04,5000,5000,0,0.00,100.00
1090529,73118P,精測群益9A售01,5000,5000,0,0.00,100.00
1090529,73119P,原相凱基9A售05,5000,5000,0,0.00,100.00
1090529,73120P,群聯凱基9A售05,5000,5000,0,0.00,100.00
1090529,73121P,中美晶元大9A售03,8000,8000,0,0.00,100.00
1090529,73122P,宏捷科元大9B售03,5000,5000,0,0.00,100.00
1090529,73123P,信驊元大9A售04,8000,8000,0,0.00,100.00
1090529,73124P,穩懋元大9A售07,6000,6000,0,0.00,100.00
1090529,73125P,精測元大9A售06,8000,8000,0,0.00,100.00
1090529,73126P,聯亞元大9A售02,8000,8000,0,0.00,100.00
1090529,73127P,鈊象元大9B售05,5000,5000,0,0.00,100.00
1090529,73128P,鈊象群益9A售04,5000,5000,0,0.00,100.00
1090529,73129P,中美晶永豐9A售02,2000,5000,-3000,-60.00,100.00
1090529,73130P,碩禾永豐9A售02,3000,5000,-2000,-40.00,100.00
1090529,73131P,聯亞凱基9A售03,5000,5000,0,0.00,100.00
1090529,73132P,大江國票9A售07,1000,5000,-4000,-80.00,100.00
1090529,73133P,神盾國票9B售02,4000,5000,-1000,-20.00,100.00
1090529,73134P,神盾國票9B售03,2500,5000,-2500,-50.00,100.00
1090529,73135P,雙鴻國票9A售04,1000,5000,-4000,-80.00,100.00
1090529,73136P,宏捷科永豐9A售02,5000,5000,0,0.00,100.00
1090529,73137P,頎邦永豐9A售03,3000,5000,-2000,-40.00,100.00
1090529,73138P,宏捷科凱基9A售04,5000,5000,0,0.00,100.00
1090529,73139P,精測凱基9A售06,5000,5000,0,0.00,100.00
1090529,73140P,穩懋凱基9A售06,2500,5000,-2500,-50.00,100.00
1090529,73141P,神盾元大9A售07,5000,5000,0,0.00,100.00
1090529,73142P,精測群益9A售03,5000,5000,0,0.00,100.00
1090529,73143P,環球晶富邦9B售04,10000,10000,0,0.00,100.00
1090529,73144P,大江元大9A售06,5000,5000,0,0.00,100.00
1090529,73145P,宏捷科元大9A售04,8000,8000,0,0.00,100.00
1090529,73146P,頎邦元大9A售02,10000,10000,0,0.00,100.00
1090529,73147P,信驊群益9A售03,5000,5000,0,0.00,100.00
1090529,73148P,宏捷科國票9A售05,1000,5000,-4000,-80.00,100.00
1090529,73149P,穩懋中信9C售02,5000,5000,0,0.00,100.00
1090529,73150P,威剛永豐9A售02,4500,5000,-500,-10.00,100.00
1090529,73151P,精測永豐9A售04,3000,5000,-2000,-40.00,100.00
1090529,73152P,穩懋永豐9A售03,2500,5000,-2500,-50.00,100.00
1090529,73153P,威剛元大9A售07,5000,5000,0,0.00,100.00
1090529,73154P,神盾元大9B售03,5000,5000,0,0.00,100.00
1090529,73155P,群聯元大9A售12,5000,5000,0,0.00,100.00
1090529,73156P,聯亞群益9A售01,5000,5000,0,0.00,100.00
1090529,73157P,宏捷科凱基9A售05,5000,5000,0,0.00,100.00
1090529,73158P,環球晶凱基9A售04,5000,5000,0,0.00,100.00
1090529,73159P,聯亞國票9A售02,5000,5000,0,0.00,100.00
1090529,73160P,精測元大9A售07,10000,10000,0,0.00,100.00
1090529,73161P,鈊象群益9A售05,5000,5000,0,0.00,100.00
1090529,73162P,穩懋統一9B售04,10000,10000,0,0.00,100.00
1090529,73163P,大江國票9A售08,5000,5000,0,0.00,100.00
1090529,73164P,台燿元大9A售01,10000,10000,0,0.00,100.00
1090529,73165P,緯軟元大9A售02,10000,10000,0,0.00,100.00
1090529,73166P,聯亞元大9A售03,10000,10000,0,0.00,100.00
1090529,73167P,櫃200元大9A售01,20000,20000,0,0.00,100.00
1090529,73168P,信驊群益9A售04,5000,5000,0,0.00,100.00
1090529,73169P,信驊國票9A售05,5000,5000,0,0.00,100.00
1090529,73170P,穩懋國票9A售05,5000,5000,0,0.00,100.00
1090529,73171P,神盾凱基9A售03,5000,5000,0,0.00,100.00
1090529,73172P,群聯永豐9B售01,5000,5000,0,0.00,100.00
1090529,73173P,台燿群益9B售01,5000,5000,0,0.00,100.00
1090529,73174P,環球晶群益9B售03,5000,5000,0,0.00,100.00
1090529,73175P,鈊象永豐9B售01,5000,5000,0,0.00,100.00
1090529,73176P,威剛國票9B售03,5000,5000,0,0.00,100.00
1090529,73177P,聯亞國票9B售02,5000,5000,0,0.00,100.00
1090529,73178P,環球晶中信9C售03,5000,5000,0,0.00,100.00
1090529,73179P,鈊象群益9B售02,5000,5000,0,0.00,100.00
1090529,73180P,穩懋元大9B售02,8000,8000,0,0.00,100.00
1090529,73181P,穩懋統一9B售07,10000,10000,0,0.00,100.00
1090529,73182P,神盾元大9C售01,5000,5000,0,0.00,100.00
1090529,73183P,環球晶群益9B售06,5000,5000,0,0.00,100.00
1090529,73184P,精華元大9B售01,8000,8000,0,0.00,100.00
1090529,73185P,原相群益9B售06,5000,5000,0,0.00,100.00
1090529,73186P,群聯群益9B售03,5000,5000,0,0.00,100.00
1090529,73187P,鈊象群益9B售03,5000,5000,0,0.00,100.00
1090529,73188P,環球晶統一9B售03,5000,5000,0,0.00,100.00
1090529,73189P,穩懋統一9B售09,10000,10000,0,0.00,100.00
1090529,73190P,原相群益9B售07,5000,5000,0,0.00,100.00
1090529,73191P,群聯群益9B售04,5000,5000,0,0.00,100.00
1090529,73192P,穩懋凱基9B售02,5000,5000,0,0.00,100.00
1090529,73193P,神盾元大9B售04,5000,5000,0,0.00,100.00
1090529,73194P,環球晶統一9B售04,12000,12000,0,0.00,100.00
1090529,73195P,鈊象統一9B售01,10000,10000,0,0.00,100.00
1090529,73196P,威剛元大9B售05,5000,5000,0,0.00,100.00
1090529,73197P,緯軟群益9B售01,5000,5000,0,0.00,100.00
1090529,73198P,頎邦群益9C售02,5000,5000,0,0.00,100.00
1090529,73199P,雙鴻國票9B售04,5000,5000,0,0.00,100.00
1090529,73200P,神盾永豐9B售01,5000,5000,0,0.00,100.00
1090529,73201P,台燿凱基9B售02,5000,5000,0,0.00,100.00
1090529,73202P,穩懋凱基9B售04,5000,5000,0,0.00,100.00
1090529,73203P,泰博國票9B售01,5000,5000,0,0.00,100.00
1090529,73204P,大江群益9B售02,5000,5000,0,0.00,100.00
1090529,73205P,大學光國票9C售02,5000,5000,0,0.00,100.00
1090529,73206P,群聯國票9C售01,5000,5000,0,0.00,100.00
1090529,73207P,環球晶國票9B售03,5000,5000,0,0.00,100.00
1090529,73208P,世界凱基9B售02,5000,5000,0,0.00,100.00
1090529,73209P,信驊元大9B售03,8000,8000,0,0.00,100.00
1090529,73210P,群聯元大9B售08,5000,5000,0,0.00,100.00
1090529,73211P,環球晶元富9B售05,5000,5000,0,0.00,100.00
1090529,73212P,精測國泰9C售03,5000,5000,0,0.00,100.00
1090529,73213P,宇峻國票9C售01,5000,5000,0,0.00,100.00
1090529,73214P,鈊象國票9C售01,5000,5000,0,0.00,100.00
1090529,73215P,群聯凱基9B售08,5000,5000,0,0.00,100.00
1090529,73216P,環球晶凱基9B售06,5000,5000,0,0.00,100.00
1090529,73217P,中美晶元富9B售04,5000,5000,0,0.00,100.00
1090529,73218P,信驊元富9B售02,5000,5000,0,0.00,100.00
1090529,73219P,鈊象元大9B售07,5000,0,5000,0.00,100.00
1090529,73220P,雙鴻永豐9B售02,5000,0,5000,0.00,100.00
1090529,73221P,網家國票9B售03,5000,0,5000,0.00,100.00
1090529,73222P,雙美國票9C售01,5000,0,5000,0.00,100.00
1090529,73223P,穩懋元富9B售01,5000,0,5000,0.00,100.00
1090529,73224P,碩禾台新9B售01,5000,0,5000,0.00,100.00
1090529,73225P,原相國泰9C售02,5000,0,5000,0.00,100.00
1090529,73226P,群聯元大9B售11,5000,0,5000,0.00,100.00
1090529,73227P,穩懋統一9B售10,15000,0,15000,0.00,100.00
1090529,73228P,新普元富9B售02,5000,0,5000,0.00,100.00
1090529,73229P,穩懋元富9B售02,5000,0,5000,0.00,100.00
1090529,73230P,信驊永豐9B售02,5000,0,5000,0.00,100.00
1090529,73231P,元太元富9B售03,5000,0,5000,0.00,100.00
1090529,73232P,新普群益9C售02,5000,0,5000,0.00,100.00
1090529,73233P,聯亞國票9C售01,5000,0,5000,0.00,100.00
1090529,73234P,鈊象國票9C售02,5000,0,5000,0.00,100.00
1090529,73235P,信驊元大9B售04,8000,0,8000,0.00,100.00
1090529,73236P,雙鴻元大9B售03,5000,0,5000,0.00,100.00
1090529,7402  ,邑錡,22224,22224,0,0.00,100.00
1090529,80114 ,台通四,3000,3000,0,0.00,100.00
1090529,8024  ,佑華,45160,45160,0,0.00,100.00
1090529,8027  ,鈦昇,81461,81461,0,0.00,100.00
1090529,80272 ,鈦昇二,4000,4000,0,0.00,100.00
1090529,80281 ,昇陽半導體一,10000,10000,0,0.00,100.00
1090529,8032  ,光菱,51810,51810,0,0.00,100.00
1090529,8034  ,榮群,62873,62873,0,0.00,100.00
1090529,8038  ,長園科,58514,58514,0,0.00,100.00
1090529,8040  ,九暘電,67216,67216,0,0.00,100.00
1090529,8042  ,金山電,122030,122030,0,0.00,100.00
1090529,80425 ,金山電五,7000,7000,0,0.00,100.00
1090529,8043  ,蜜望實,79907,79907,0,0.00,100.00
1090529,8044  ,網家,117159,117159,0,0.00,100.00
1090529,8047  ,星雲,41666,41666,0,0.00,100.00
1090529,8048  ,德勝,53264,53264,0,0.00,100.00
1090529,8049  ,晶采,118279,118279,0,0.00,100.00
1090529,8050  ,廣積,177099,177099,0,0.00,100.00
1090529,8054  ,安國,70823,75820,-4997,-6.59,93.40
1090529,8059  ,凱碩,86118,86118,0,0.00,100.00
1090529,8064  ,東捷,164817,164817,0,0.00,100.00
1090529,8066  ,來思達,29996,29996,0,0.00,100.00
1090529,80661 ,來思達一,3000,3000,0,0.00,100.00
1090529,8067  ,志旭,21000,21000,0,0.00,100.00
1090529,8068  ,全達,32364,32364,0,0.00,100.00
1090529,8069  ,元太,1080467,1080467,0,0.00,100.00
1090529,8071  ,能率網通,51854,51854,0,0.00,100.00
1090529,8074  ,鉅橡,86501,86501,0,0.00,100.00
1090529,80745 ,鉅橡五,94,94,0,0.00,2.08
1090529,8076  ,伍豐,259158,259158,0,0.00,100.00
1090529,80764 ,伍豐四,6000,6000,0,0.00,100.00
1090529,8077  ,洛&#30849;,50294,50294,0,0.00,100.00
1090529,8080  ,永利聯合,53319,53319,0,0.00,100.00
1090529,8083  ,瑞穎,35133,35133,0,0.00,100.00
1090529,8084  ,巨虹,40436,40436,0,0.00,100.00
1090529,8085  ,福華,157257,157257,0,0.00,100.00
1090529,8086  ,宏捷科,154716,154716,0,0.00,100.00
1090529,8087  ,華鎂鑫,29868,29868,0,0.00,100.00
1090529,8088  ,品安,60921,60921,0,0.00,100.00
1090529,8091  ,翔名,44686,44686,0,0.00,100.00
1090529,8092  ,建暐,38850,38850,0,0.00,100.00
1090529,8093  ,保銳科,64208,64208,0,0.00,100.00
1090529,8096  ,擎亞電子,139623,139623,0,0.00,100.00
1090529,8097  ,常珵,26674,26674,0,0.00,100.00
1090529,8099  ,大世科,88560,88560,0,0.00,100.00
1090529,8107  ,大億金茂,75000,75000,0,0.00,100.00
1090529,8109  ,博大,72609,72609,0,0.00,100.00
1090529,81102 ,華東二,6000,6000,0,0.00,100.00
1090529,8111  ,立&#30849;,98425,100425,-2000,-1.99,100.00
1090529,8121  ,越峰,182993,182993,0,0.00,100.00
1090529,8147  ,正淩,27518,27518,0,0.00,100.00
1090529,8155  ,博智,49756,49756,0,0.00,100.00
1090529,8171  ,天宇,50723,50723,0,0.00,100.00
1090529,8176  ,智捷,72500,72500,0,0.00,100.00
1090529,8182  ,加高,107041,107041,0,0.00,100.00
1090529,8183  ,精星,121251,121251,0,0.00,100.00
1090529,8234  ,新漢,141226,141226,0,0.00,100.00
1090529,8240  ,華宏,100004,100004,0,0.00,100.00
1090529,8255  ,朋程,91513,91513,0,0.00,100.00
1090529,8277  ,商丞,91628,91628,0,0.00,100.00
1090529,8279  ,生展,27100,27100,0,0.00,100.00
1090529,8284  ,三竹,46342,46342,0,0.00,100.00
1090529,8289  ,泰藝,68333,68333,0,0.00,100.00
1090529,8291  ,尚茂,76024,76024,0,0.00,100.00
1090529,8299  ,群聯,197073,197073,0,0.00,100.00
1090529,8342  ,益張,33536,33536,0,0.00,100.00
1090529,8349  ,&#24658;耀,116382,116382,0,0.00,100.00
1090529,83493 ,&#24658;耀三,1485,1485,0,0.00,9.90
1090529,83494 ,&#24658;耀四,5000,5000,0,0.00,100.00
1090529,8354  ,冠好,78532,78532,0,0.00,100.00
1090529,8358  ,金居,252588,252588,0,0.00,100.00
1090529,8383  ,千附,118192,118192,0,0.00,100.00
1090529,8390  ,金益鼎,77560,77560,0,0.00,100.00
1090529,83905 ,金益鼎五,5000,5000,0,0.00,100.00
1090529,8401  ,白紗科,62729,62729,0,0.00,100.00
1090529,8403  ,盛弘,102488,102488,0,0.00,100.00
1090529,84033 ,盛弘三,1438,1438,0,0.00,95.86
1090529,8406  ,金可-KY,92450,92450,0,0.00,100.00
1090529,8409  ,商之器,28000,28000,0,0.00,100.00
1090529,8410  ,森田,36589,36589,0,0.00,100.00
1090529,8415  ,大國鋼,1031500,1031500,0,0.00,100.00
1090529,8416  ,實威,28210,28210,0,0.00,100.00
1090529,8418  ,捷必勝-KY,67995,67995,0,0.00,100.00
1090529,8420  ,明揚,50990,50990,0,0.00,100.00
1090529,8421  ,旭源,54817,54817,0,0.00,100.00
1090529,8423  ,保綠-KY,22075,22075,0,0.00,100.00
1090529,8424  ,惠普,36054,36054,0,0.00,100.00
1090529,8426  ,紅木-KY,50242,50242,0,0.00,100.00
1090529,8431  ,匯鑽科,44455,44455,0,0.00,100.00
1090529,8432  ,東生華,38398,38398,0,0.00,100.00
1090529,8433  ,弘帆,52081,52081,0,0.00,99.05
1090529,8435  ,鉅邁,31700,31700,0,0.00,100.00
1090529,8436  ,大江,119617,119617,0,0.00,100.00
1090529,84362 ,大江二,4354,4354,0,0.00,36.28
1090529,8437  ,大地-KY,47851,47851,0,0.00,100.00
1090529,8440  ,綠電,38000,38000,0,0.00,100.00
1090529,8444  ,綠河-KY,73770,73770,0,0.00,100.00
1090529,8446  ,華研,52914,52914,0,0.00,100.00
1090529,8450  ,霹靂,51309,51309,0,0.00,100.00
1090529,8455  ,大拓-KY,25219,25219,0,0.00,100.00
1090529,8472  ,夠麻吉,18338,18338,0,0.00,100.00
1090529,84731 ,山林水一,5000,5000,0,0.00,100.00
1090529,8476  ,台境,40510,40510,0,0.00,100.00
1090529,84761 ,台境一,1000,1000,0,0.00,100.00
1090529,8477  ,創業家,24961,24961,0,0.00,100.00
1090529,8489  ,三貝德,37752,37752,0,0.00,100.00
1090529,84991 ,鼎炫一KY,5000,5000,0,0.00,100.00
1090529,8905  ,裕國,119440,119440,0,0.00,100.00
1090529,8906  ,花王企業,34037,34037,0,0.00,100.00
1090529,8908  ,欣雄,180250,180250,0,0.00,100.00
1090529,8916  ,光隆,131016,131016,0,0.00,100.00
1090529,8917  ,欣泰,122203,122203,0,0.00,100.00
1090529,8921  ,沈氏印刷,46592,46592,0,0.00,100.00
1090529,8923  ,時報,30375,30375,0,0.00,100.00
1090529,8924  ,大田,83800,83800,0,0.00,100.00
1090529,8927  ,北基,131833,131833,0,0.00,100.00
1090529,8928  ,鉅明,50854,50854,0,0.00,100.00
1090529,8929  ,富堡,50580,50580,0,0.00,100.00
1090529,8930  ,青鋼,80669,80669,0,0.00,100.00
1090529,8931  ,大汽電,122254,122254,0,0.00,100.00
1090529,8932  ,宏大,37800,37800,0,0.00,100.00
1090529,8933  ,愛地雅,126250,126250,0,0.00,100.00
1090529,89334 ,愛地雅四,2786,2786,0,0.00,92.86
1090529,89335 ,愛地雅五,4000,4000,0,0.00,100.00
1090529,8934  ,衡平,8510,8510,0,0.00,100.00
1090529,8935  ,邦泰,84300,84300,0,0.00,100.00
1090529,8936  ,國統,249224,249224,0,0.00,100.00
1090529,8937  ,合騏,72478,72478,0,0.00,100.00
1090529,8938  ,明安,135312,135312,0,0.00,100.00
1090529,8941  ,關中,13902,13902,0,0.00,100.00
1090529,8942  ,森鉅,165840,165840,0,0.00,100.00
1090529,911613,特藝-DR,11111,11111,0,0.00,100.00
1090529,98024 ,鈺齊四KY,526,526,0,0.00,5.26
1090529,9949  ,琉園,47033,47033,0,0.00,100.00
1090529,9950  ,萬國通,99716,99716,0,0.00,100.00
1090529,9951  ,皇田,74900,74900,0,0.00,100.00
1090529,99582 ,世紀鋼二,2997,2997,0,0.00,99.90
1090529,99583 ,世紀鋼三,3298,3298,0,0.00,47.11
1090529,9960  ,邁達康,33592,33592,0,0.00,100.00
1090529,9962  ,有益,90220,90220,0,0.00,100.00
